date;lat;lon;Вход;Выход;Разница
5:00;37.3622257;55.8458623;320;2;318
5:00;37.3824179;55.8356604;84;0;84
5:00;37.3855554;55.825092;8;0;8
5:00;37.4031859;55.8037346;352;7;345
5:00;37.4082585;55.7568353;196;9;187
5:00;37.4169177;55.7408429;364;27;337
5:00;37.4363874;55.860731;502;26;476
5:00;37.4366398;55.8264976;556;97;459
5:00;37.4397991;55.8503173;704;21;683
5:00;37.4459574;55.7308185;46;29;17
5:00;37.4460094;55.7307016;171;17;154
5:00;37.4643097;55.8085823;376;49;327
5:00;37.4671944;55.7359279;31;7;24
5:00;37.4707354;55.7296453;227;26;201
5:00;37.4761955;55.8548635;519;41;478
5:00;37.4832383;55.6636112;597;38;559
5:00;37.4834225;55.7394565;77;15;62
5:00;37.4865846;55.8400444;389;19;370
5:00;37.4937378;55.7933364;281;60;221
5:00;37.4978443;55.7436954;78;34;44
5:00;37.4978477;55.8190209;443;65;378
5:00;37.506415;55.6767308;485;17;468
5:00;37.5080944;55.6186964;517;29;488
5:00;37.5148913;55.8049784;228;62;166
5:00;37.5149237;55.7460754;142;36;106
5:00;37.5177438;55.7362565;44;34;10
5:00;37.5190729;55.6330883;189;17;172
5:00;37.5194078;55.7775074;209;172;37
5:00;37.5262001;55.6425059;293;30;263
5:00;37.5324136;55.8002374;137;64;73
5:00;37.5337173;55.6062069;589;15;574
5:00;37.5340698;55.692163;234;23;211
5:00;37.53429;55.7400038;26;14;12
5:00;37.534383;55.7483228;50;20;30
5:00;37.5401361;55.6567573;231;113;118
5:00;37.5413387;55.7500562;74;11;63
5:00;37.5464401;55.7735045;107;163;-56
5:00;37.5483675;55.7388362;36;10;26
5:00;37.5528619;55.6016929;183;4;179
5:00;37.5547367;55.670291;327;57;270
5:00;37.5581576;55.7897125;117;91;26
5:00;37.5591032;55.7103574;14;10;4
5:00;37.5615355;55.7645028;148;177;-29
5:00;37.5629779;55.6779484;215;56;159
5:00;37.5637548;55.7233832;107;43;64
5:00;37.5660392;55.7444645;995;132;863
5:00;37.5663098;55.7437756;492;131;361
5:00;37.5736132;55.6878389;258;52;206
5:00;37.5740376;55.8347143;821;105;716
5:00;37.5756626;55.8182119;460;67;393
5:00;37.5768339;55.56931;1195;16;1179
5:00;37.5773899;55.7605891;79;56;23
5:00;37.5794779;55.726854;109;52;57
5:00;37.5798606;55.7609017;57;98;-41
5:00;37.5812016;55.8074277;195;96;99
5:00;37.5822992;55.7473712;157;110;47
5:00;37.5826348;55.7487722;23;21;2
5:00;37.5837069;55.7766908;243;91;152
5:00;37.5840306;55.7761643;382;187;195
5:00;37.5859796;55.7077138;130;102;28
5:00;37.5873192;55.8978497;583;17;566
5:00;37.5876906;55.7928665;201;146;55
5:00;37.5898414;55.8472205;263;45;218
5:00;37.5943769;55.7355873;88;75;13
5:00;37.5943769;55.7355873;0;0;0
5:00;37.5957904;55.7701264;72;129;-57
5:00;37.5964216;55.582549;235;19;216
5:00;37.5981698;55.6529571;241;92;149
5:00;37.598314;55.6520286;102;5;97
5:00;37.6007529;55.7518731;10;11;-1
5:00;37.6009269;55.5951773;357;21;336
5:00;37.6020659;55.779514;73;101;-28
5:00;37.6024384;55.8836915;637;26;611
5:00;37.6029929;55.7803918;24;83;-59
5:00;37.6032245;55.7450091;32;80;-48
5:00;37.6041499;55.6124609;635;50;585
5:00;37.6048165;55.8634536;724;48;676
5:00;37.6056238;55.7653522;102;176;-74
5:00;37.6056692;55.6627149;188;49;139
5:00;37.6066657;55.7508858;4;32;-28
5:00;37.6067634;55.64069;517;63;454
5:00;37.6068123;55.7521318;86;105;-19
5:00;37.60792;55.7194704;109;98;11
5:00;37.608832;55.7524514;24;42;-18
5:00;37.6091534;55.7295817;42;83;-41
5:00;37.6091666;55.622278;360;36;324
5:00;37.6097183;55.7649696;66;92;-26
5:00;37.6103732;55.6722659;127;26;101
5:00;37.6118212;55.730075;24;76;-52
5:00;37.6150302;55.7813266;38;22;16
5:00;37.61611;55.7953478;122;49;73
5:00;37.616177;55.7577183;54;197;-143
5:00;37.6176267;55.7379525;30;81;-51
5:00;37.6187593;55.6533004;434;101;333
5:00;37.6188598;55.7710979;52;72;-20
5:00;37.6202837;55.7685309;30;45;-15
5:00;37.621965;55.7566721;82;78;4
5:00;37.6220906;55.7287137;49;80;-31
5:00;37.6227483;55.6830582;279;114;165
5:00;37.6231936;55.7087682;177;157;20
5:00;37.6248369;55.7274387;82;103;-21
5:00;37.626016;55.7607712;58;128;-70
5:00;37.6270765;55.7408687;41;132;-91
5:00;37.6279157;55.7598754;35;55;-20
5:00;37.6290658;55.7417709;75;179;-104
5:00;37.6317458;55.7728672;46;70;-24
5:00;37.6323159;55.7812257;46;59;-13
5:00;37.6331969;55.7797556;99;88;11
5:00;37.633222;55.7555058;163;348;-185
5:00;37.6361518;55.7933484;88;76;12
5:00;37.6372552;55.76613;80;93;-13
5:00;37.6374183;55.7304321;397;227;170
5:00;37.63768;55.7317782;506;127;379
5:00;37.6383529;55.8453055;253;38;215
5:00;37.6387088;55.8086032;119;120;-1
5:00;37.6389332;55.7659277;40;55;-15
5:00;37.6398306;55.7668232;16;44;-28
5:00;37.6411949;55.8211047;270;66;204
5:00;37.6484221;55.768931;80;121;-41
5:00;37.6491378;55.6549517;850;101;749
5:00;37.6506474;55.7416183;90;82;8
5:00;37.6519536;55.740344;47;40;7
5:00;37.6526488;55.7413884;89;83;6
5:00;37.6526672;55.8551422;406;39;367
5:00;37.6545092;55.7748736;1404;163;1241
5:00;37.656231;55.7754248;1860;251;1609
5:00;37.6565565;55.6358179;610;64;546
5:00;37.656572;55.7571067;403;133;270
5:00;37.6576183;55.7073699;202;162;40
5:00;37.658076;55.7581501;742;158;584
5:00;37.6591277;55.7572695;48;35;13
5:00;37.6614511;55.8871576;827;15;812
5:00;37.6638965;55.6784809;869;95;774
5:00;37.6641638;55.8697248;666;20;646
5:00;37.6661457;55.7317659;169;128;41
5:00;37.6667866;55.7330126;23;42;-19
5:00;37.6672754;55.7803946;138;125;13
5:00;37.6693833;55.6215598;786;97;689
5:00;37.6756382;55.718932;56;80;-24
5:00;37.6801346;55.7889129;136;69;67
5:00;37.6801957;55.7729753;134;145;-11
5:00;37.6820384;55.7464709;191;96;95
5:00;37.6822989;55.7457322;92;52;40
5:00;37.6850483;55.7075562;140;97;43
5:00;37.6867847;55.7253024;78;120;-42
5:00;37.6947891;55.613247;438;12;426
5:00;37.7038734;55.7820537;112;88;24
5:00;37.7157645;55.7961475;452;57;395
5:00;37.7193262;55.6109687;818;42;776
5:00;37.7200209;55.7520069;257;192;65
5:00;37.7207673;55.7830875;169;123;46
5:00;37.7268243;55.6933636;492;34;458
5:00;37.7318594;55.7087389;758;174;584
5:00;37.7344362;55.8146017;356;32;324
5:00;37.7431944;55.6500225;794;41;753
5:00;37.7433398;55.6331579;175;4;171
5:00;37.743772;55.621144;129;6;123
5:00;37.7445335;55.6137894;880;19;861
5:00;37.7447684;55.8039662;203;25;178
5:00;37.7452899;55.61193;100;13;87
5:00;37.7498443;55.757225;405;75;330
5:00;37.7506502;55.6596899;738;23;715
5:00;37.750729;55.788524;223;36;187
5:00;37.7532335;55.6907556;320;32;288
5:00;37.7619338;55.6756254;910;82;828
5:00;37.7657487;55.7055754;1286;93;1193
5:00;37.7814948;55.787812;223;25;198
5:00;37.7864677;55.751266;483;35;448
5:00;37.7935753;55.7170907;641;62;579
5:00;37.7985144;55.8093419;1606;27;1579
5:00;37.7992368;55.7947324;506;29;477
5:00;37.8166274;55.7517187;1645;41;1604
5:00;37.8179174;55.715631;2250;78;2172
6:00;37.3622257;55.8458623;2375;193;2182
6:00;37.3824179;55.8356604;383;79;304
6:00;37.3855554;55.825092;46;44;2
6:00;37.4031859;55.8037346;1373;325;1048
6:00;37.4082585;55.7568353;905;279;626
6:00;37.4169177;55.7408429;1606;1034;572
6:00;37.4363874;55.860731;2677;688;1989
6:00;37.4366398;55.8264976;2876;2139;737
6:00;37.4397991;55.8503173;3033;641;2392
6:00;37.4459574;55.7308185;362;261;101
6:00;37.4460094;55.7307016;976;570;406
6:00;37.4643097;55.8085823;1614;897;717
6:00;37.4671944;55.7359279;178;69;109
6:00;37.4707354;55.7296453;1431;879;552
6:00;37.4761955;55.8548635;3631;1105;2526
6:00;37.4832383;55.6636112;4131;1425;2706
6:00;37.4834225;55.7394565;395;176;219
6:00;37.4865846;55.8400444;1555;709;846
6:00;37.4937378;55.7933364;1580;972;608
6:00;37.4978443;55.7436954;365;628;-263
6:00;37.4978477;55.8190209;1912;1299;613
6:00;37.506415;55.6767308;1428;564;864
6:00;37.5080944;55.6186964;2758;869;1889
6:00;37.5148913;55.8049784;601;863;-262
6:00;37.5149237;55.7460754;760;957;-197
6:00;37.5177438;55.7362565;375;376;-1
6:00;37.5190729;55.6330883;1118;309;809
6:00;37.5194078;55.7775074;1314;2166;-852
6:00;37.5262001;55.6425059;1258;367;891
6:00;37.5324136;55.8002374;608;752;-144
6:00;37.5337173;55.6062069;2414;271;2143
6:00;37.5340698;55.692163;662;607;55
6:00;37.53429;55.7400038;96;203;-107
6:00;37.534383;55.7483228;75;213;-138
6:00;37.5401361;55.6567573;751;1722;-971
6:00;37.5413387;55.7500562;149;381;-232
6:00;37.5464401;55.7735045;925;1809;-884
6:00;37.5483675;55.7388362;141;103;38
6:00;37.5528619;55.6016929;532;47;485
6:00;37.5547367;55.670291;1072;603;469
6:00;37.5581576;55.7897125;506;958;-452
6:00;37.5591032;55.7103574;47;180;-133
6:00;37.5615355;55.7645028;785;1842;-1057
6:00;37.5629779;55.6779484;976;586;390
6:00;37.5637548;55.7233832;297;503;-206
6:00;37.5660392;55.7444645;1571;1506;65
6:00;37.5663098;55.7437756;1128;1282;-154
6:00;37.5736132;55.6878389;991;575;416
6:00;37.5740376;55.8347143;3608;1618;1990
6:00;37.5756626;55.8182119;1903;901;1002
6:00;37.5768339;55.56931;4242;648;3594
6:00;37.5773899;55.7605891;222;630;-408
6:00;37.5794779;55.726854;235;640;-405
6:00;37.5798606;55.7609017;108;528;-420
6:00;37.5812016;55.8074277;753;1151;-398
6:00;37.5822992;55.7473712;228;994;-766
6:00;37.5826348;55.7487722;54;151;-97
6:00;37.5837069;55.7766908;670;922;-252
6:00;37.5840306;55.7761643;927;1330;-403
6:00;37.5859796;55.7077138;424;1275;-851
6:00;37.5873192;55.8978497;4052;749;3303
6:00;37.5876906;55.7928665;803;1428;-625
6:00;37.5898414;55.8472205;886;622;264
6:00;37.5943769;55.7355873;163;776;-613
6:00;37.5943769;55.7355873;0;0;0
6:00;37.5957904;55.7701264;199;746;-547
6:00;37.5964216;55.582549;1127;477;650
6:00;37.5981698;55.6529571;1134;644;490
6:00;37.598314;55.6520286;295;131;164
6:00;37.6007529;55.7518731;29;135;-106
6:00;37.6009269;55.5951773;1625;288;1337
6:00;37.6020659;55.779514;233;1141;-908
6:00;37.6024384;55.8836915;2215;318;1897
6:00;37.6029929;55.7803918;174;1111;-937
6:00;37.6032245;55.7450091;132;743;-611
6:00;37.6041499;55.6124609;2341;692;1649
6:00;37.6048165;55.8634536;3018;622;2396
6:00;37.6056238;55.7653522;209;1161;-952
6:00;37.6056692;55.6627149;658;377;281
6:00;37.6066657;55.7508858;14;204;-190
6:00;37.6067634;55.64069;1883;600;1283
6:00;37.6068123;55.7521318;122;663;-541
6:00;37.60792;55.7194704;411;938;-527
6:00;37.608832;55.7524514;55;562;-507
6:00;37.6091534;55.7295817;130;655;-525
6:00;37.6091666;55.622278;1242;501;741
6:00;37.6097183;55.7649696;110;506;-396
6:00;37.6103732;55.6722659;441;502;-61
6:00;37.6118212;55.730075;132;476;-344
6:00;37.6150302;55.7813266;106;328;-222
6:00;37.61611;55.7953478;440;593;-153
6:00;37.616177;55.7577183;180;1233;-1053
6:00;37.6176267;55.7379525;73;527;-454
6:00;37.6187593;55.6533004;2272;1215;1057
6:00;37.6188598;55.7710979;156;529;-373
6:00;37.6202837;55.7685309;71;309;-238
6:00;37.621965;55.7566721;82;769;-687
6:00;37.6220906;55.7287137;131;578;-447
6:00;37.6227483;55.6830582;1475;1052;423
6:00;37.6231936;55.7087682;646;1390;-744
6:00;37.6248369;55.7274387;239;663;-424
6:00;37.626016;55.7607712;89;706;-617
6:00;37.6270765;55.7408687;126;759;-633
6:00;37.6279157;55.7598754;56;410;-354
6:00;37.6290658;55.7417709;222;1003;-781
6:00;37.6317458;55.7728672;179;389;-210
6:00;37.6323159;55.7812257;162;512;-350
6:00;37.6331969;55.7797556;231;730;-499
6:00;37.633222;55.7555058;206;1791;-1585
6:00;37.6361518;55.7933484;487;593;-106
6:00;37.6372552;55.76613;118;463;-345
6:00;37.6374183;55.7304321;659;1721;-1062
6:00;37.63768;55.7317782;1086;1063;23
6:00;37.6383529;55.8453055;791;494;297
6:00;37.6387088;55.8086032;565;1142;-577
6:00;37.6389332;55.7659277;93;389;-296
6:00;37.6398306;55.7668232;29;199;-170
6:00;37.6411949;55.8211047;954;720;234
6:00;37.6484221;55.768931;200;804;-604
6:00;37.6491378;55.6549517;1324;1125;199
6:00;37.6506474;55.7416183;302;647;-345
6:00;37.6519536;55.740344;147;321;-174
6:00;37.6526488;55.7413884;327;751;-424
6:00;37.6526672;55.8551422;1406;529;877
6:00;37.6545092;55.7748736;2464;989;1475
6:00;37.656231;55.7754248;5094;1624;3470
6:00;37.6565565;55.6358179;2693;867;1826
6:00;37.656572;55.7571067;1937;980;957
6:00;37.6576183;55.7073699;701;1669;-968
6:00;37.658076;55.7581501;2075;923;1152
6:00;37.6591277;55.7572695;168;293;-125
6:00;37.6614511;55.8871576;3643;678;2965
6:00;37.6638965;55.6784809;2195;1013;1182
6:00;37.6641638;55.8697248;2855;429;2426
6:00;37.6661457;55.7317659;704;902;-198
6:00;37.6667866;55.7330126;85;204;-119
6:00;37.6672754;55.7803946;688;1476;-788
6:00;37.6693833;55.6215598;4063;1295;2768
6:00;37.6756382;55.718932;219;735;-516
6:00;37.6801346;55.7889129;438;736;-298
6:00;37.6801957;55.7729753;552;1384;-832
6:00;37.6820384;55.7464709;1417;1020;397
6:00;37.6822989;55.7457322;591;593;-2
6:00;37.6850483;55.7075562;485;1090;-605
6:00;37.6867847;55.7253024;177;1154;-977
6:00;37.6947891;55.613247;1367;191;1176
6:00;37.7038734;55.7820537;833;1248;-415
6:00;37.7157645;55.7961475;1546;872;674
6:00;37.7193262;55.6109687;3998;1073;2925
6:00;37.7200209;55.7520069;984;2044;-1060
6:00;37.7207673;55.7830875;721;2289;-1568
6:00;37.7268243;55.6933636;1525;500;1025
6:00;37.7318594;55.7087389;2552;1831;721
6:00;37.7344362;55.8146017;1441;784;657
6:00;37.7431944;55.6500225;4629;514;4115
6:00;37.7433398;55.6331579;1659;116;1543
6:00;37.743772;55.621144;978;88;890
6:00;37.7445335;55.6137894;3315;340;2975
6:00;37.7447684;55.8039662;628;442;186
6:00;37.7452899;55.61193;848;106;742
6:00;37.7498443;55.757225;934;1227;-293
6:00;37.7506502;55.6596899;2796;418;2378
6:00;37.750729;55.788524;829;538;291
6:00;37.7532335;55.6907556;999;221;778
6:00;37.7619338;55.6756254;3273;972;2301
6:00;37.7657487;55.7055754;5486;881;4605
6:00;37.7814948;55.787812;862;210;652
6:00;37.7864677;55.751266;2174;455;1719
6:00;37.7935753;55.7170907;2356;650;1706
6:00;37.7985144;55.8093419;6570;977;5593
6:00;37.7992368;55.7947324;2341;379;1962
6:00;37.8166274;55.7517187;6953;872;6081
6:00;37.8179174;55.715631;11257;2125;9132
7:00;37.3622257;55.8458623;6463;770;5693
7:00;37.3824179;55.8356604;989;241;748
7:00;37.3855554;55.825092;98;348;-250
7:00;37.4031859;55.8037346;3747;1383;2364
7:00;37.4082585;55.7568353;2786;1305;1481
7:00;37.4169177;55.7408429;4914;3221;1693
7:00;37.4363874;55.860731;8123;2148;5975
7:00;37.4366398;55.8264976;8039;4483;3556
7:00;37.4397991;55.8503173;8650;2533;6117
7:00;37.4459574;55.7308185;1178;763;415
7:00;37.4460094;55.7307016;2962;1932;1030
7:00;37.4643097;55.8085823;4265;3966;299
7:00;37.4671944;55.7359279;560;179;381
7:00;37.4707354;55.7296453;3712;3226;486
7:00;37.4761955;55.8548635;9319;2944;6375
7:00;37.4832383;55.6636112;9991;5163;4828
7:00;37.4834225;55.7394565;1186;635;551
7:00;37.4865846;55.8400444;4469;2877;1592
7:00;37.4937378;55.7933364;4682;3823;859
7:00;37.4978443;55.7436954;1080;1475;-395
7:00;37.4978477;55.8190209;5463;5260;203
7:00;37.506415;55.6767308;3724;2564;1160
7:00;37.5080944;55.6186964;6888;2640;4248
7:00;37.5148913;55.8049784;2051;3604;-1553
7:00;37.5149237;55.7460754;2868;2354;514
7:00;37.5177438;55.7362565;861;1607;-746
7:00;37.5190729;55.6330883;3712;1630;2082
7:00;37.5194078;55.7775074;3797;5267;-1470
7:00;37.5262001;55.6425059;4095;1399;2696
7:00;37.5324136;55.8002374;1813;4388;-2575
7:00;37.5337173;55.6062069;6308;1206;5102
7:00;37.5340698;55.692163;2136;2953;-817
7:00;37.53429;55.7400038;270;834;-564
7:00;37.534383;55.7483228;80;627;-547
7:00;37.5401361;55.6567573;2498;5171;-2673
7:00;37.5413387;55.7500562;373;1692;-1319
7:00;37.5464401;55.7735045;4198;5157;-959
7:00;37.5483675;55.7388362;514;414;100
7:00;37.5528619;55.6016929;1400;258;1142
7:00;37.5547367;55.670291;3373;2762;611
7:00;37.5581576;55.7897125;1754;4355;-2601
7:00;37.5591032;55.7103574;57;484;-427
7:00;37.5615355;55.7645028;2044;5947;-3903
7:00;37.5629779;55.6779484;2509;2699;-190
7:00;37.5637548;55.7233832;750;2755;-2005
7:00;37.5660392;55.7444645;5626;4245;1381
7:00;37.5663098;55.7437756;2396;4591;-2195
7:00;37.5736132;55.6878389;3019;2623;396
7:00;37.5740376;55.8347143;8295;3851;4444
7:00;37.5756626;55.8182119;6058;2762;3296
7:00;37.5768339;55.56931;9581;1569;8012
7:00;37.5773899;55.7605891;543;2428;-1885
7:00;37.5794779;55.726854;825;3667;-2842
7:00;37.5798606;55.7609017;336;1886;-1550
7:00;37.5812016;55.8074277;2349;3633;-1284
7:00;37.5822992;55.7473712;487;3765;-3278
7:00;37.5826348;55.7487722;165;657;-492
7:00;37.5837069;55.7766908;2094;2869;-775
7:00;37.5840306;55.7761643;2085;4511;-2426
7:00;37.5859796;55.7077138;1263;4737;-3474
7:00;37.5873192;55.8978497;11311;1931;9380
7:00;37.5876906;55.7928665;3703;5186;-1483
7:00;37.5898414;55.8472205;2072;1692;380
7:00;37.5943769;55.7355873;551;3257;-2706
7:00;37.5943769;55.7355873;0;0;0
7:00;37.5957904;55.7701264;560;2959;-2399
7:00;37.5964216;55.582549;2927;1551;1376
7:00;37.5981698;55.6529571;3113;2072;1041
7:00;37.598314;55.6520286;958;522;436
7:00;37.6007529;55.7518731;67;571;-504
7:00;37.6009269;55.5951773;4887;956;3931
7:00;37.6020659;55.779514;677;3710;-3033
7:00;37.6024384;55.8836915;5317;980;4337
7:00;37.6029929;55.7803918;440;2725;-2285
7:00;37.6032245;55.7450091;364;3069;-2705
7:00;37.6041499;55.6124609;6180;1881;4299
7:00;37.6048165;55.8634536;8481;1925;6556
7:00;37.6056238;55.7653522;598;5102;-4504
7:00;37.6056692;55.6627149;2023;1823;200
7:00;37.6066657;55.7508858;78;845;-767
7:00;37.6067634;55.64069;4534;1817;2717
7:00;37.6068123;55.7521318;272;2727;-2455
7:00;37.60792;55.7194704;1163;3101;-1938
7:00;37.608832;55.7524514;177;1655;-1478
7:00;37.6091534;55.7295817;461;2240;-1779
7:00;37.6091666;55.622278;3252;1899;1353
7:00;37.6097183;55.7649696;248;2261;-2013
7:00;37.6103732;55.6722659;1172;1491;-319
7:00;37.6118212;55.730075;366;1658;-1292
7:00;37.6150302;55.7813266;302;1240;-938
7:00;37.61611;55.7953478;1371;2190;-819
7:00;37.616177;55.7577183;374;3879;-3505
7:00;37.6176267;55.7379525;302;1927;-1625
7:00;37.6187593;55.6533004;5332;4158;1174
7:00;37.6188598;55.7710979;448;2398;-1950
7:00;37.6202837;55.7685309;136;1104;-968
7:00;37.621965;55.7566721;152;3044;-2892
7:00;37.6220906;55.7287137;392;2108;-1716
7:00;37.6227483;55.6830582;3237;3879;-642
7:00;37.6231936;55.7087682;1659;4534;-2875
7:00;37.6248369;55.7274387;516;2534;-2018
7:00;37.626016;55.7607712;128;3000;-2872
7:00;37.6270765;55.7408687;348;3055;-2707
7:00;37.6279157;55.7598754;183;2366;-2183
7:00;37.6290658;55.7417709;466;3630;-3164
7:00;37.6317458;55.7728672;547;2265;-1718
7:00;37.6323159;55.7812257;516;2644;-2128
7:00;37.6331969;55.7797556;751;3673;-2922
7:00;37.633222;55.7555058;496;6933;-6437
7:00;37.6361518;55.7933484;1327;1947;-620
7:00;37.6372552;55.76613;336;2437;-2101
7:00;37.6374183;55.7304321;1305;5305;-4000
7:00;37.63768;55.7317782;2442;3511;-1069
7:00;37.6383529;55.8453055;2143;1737;406
7:00;37.6387088;55.8086032;1990;4364;-2374
7:00;37.6389332;55.7659277;306;1587;-1281
7:00;37.6398306;55.7668232;83;995;-912
7:00;37.6411949;55.8211047;2797;2470;327
7:00;37.6484221;55.768931;638;3562;-2924
7:00;37.6491378;55.6549517;1973;3844;-1871
7:00;37.6506474;55.7416183;736;2357;-1621
7:00;37.6519536;55.740344;387;1113;-726
7:00;37.6526488;55.7413884;896;2327;-1431
7:00;37.6526672;55.8551422;4073;1631;2442
7:00;37.6545092;55.7748736;4073;2371;1702
7:00;37.656231;55.7754248;17490;3430;14060
7:00;37.6565565;55.6358179;7619;2462;5157
7:00;37.656572;55.7571067;4975;2994;1981
7:00;37.6576183;55.7073699;1940;4735;-2795
7:00;37.658076;55.7581501;5446;2819;2627
7:00;37.6591277;55.7572695;469;1069;-600
7:00;37.6614511;55.8871576;10097;1717;8380
7:00;37.6638965;55.6784809;6451;4186;2265
7:00;37.6641638;55.8697248;8331;1441;6890
7:00;37.6661457;55.7317659;2111;3665;-1554
7:00;37.6667866;55.7330126;200;810;-610
7:00;37.6672754;55.7803946;1029;3143;-2114
7:00;37.6693833;55.6215598;10946;3208;7738
7:00;37.6756382;55.718932;581;1990;-1409
7:00;37.6801346;55.7889129;1565;3444;-1879
7:00;37.6801957;55.7729753;1709;5990;-4281
7:00;37.6820384;55.7464709;3505;2549;956
7:00;37.6822989;55.7457322;1784;2201;-417
7:00;37.6850483;55.7075562;1403;4631;-3228
7:00;37.6867847;55.7253024;421;3458;-3037
7:00;37.6947891;55.613247;4141;691;3450
7:00;37.7038734;55.7820537;2244;3703;-1459
7:00;37.7157645;55.7961475;4085;3217;868
7:00;37.7193262;55.6109687;10442;3689;6753
7:00;37.7200209;55.7520069;3245;7272;-4027
7:00;37.7207673;55.7830875;2019;5028;-3009
7:00;37.7268243;55.6933636;3931;1460;2471
7:00;37.7318594;55.7087389;6733;4077;2656
7:00;37.7344362;55.8146017;3974;2418;1556
7:00;37.7431944;55.6500225;10046;1180;8866
7:00;37.7433398;55.6331579;4127;272;3855
7:00;37.743772;55.621144;2822;299;2523
7:00;37.7445335;55.6137894;7193;1096;6097
7:00;37.7447684;55.8039662;1762;1322;440
7:00;37.7452899;55.61193;1885;349;1536
7:00;37.7498443;55.757225;1740;3769;-2029
7:00;37.7506502;55.6596899;7938;1179;6759
7:00;37.750729;55.788524;1189;1307;-118
7:00;37.7532335;55.6907556;2770;941;1829
7:00;37.7619338;55.6756254;8298;1646;6652
7:00;37.7657487;55.7055754;12368;2766;9602
7:00;37.7814948;55.787812;2530;920;1610
7:00;37.7864677;55.751266;6979;1526;5453
7:00;37.7935753;55.7170907;6434;1834;4600
7:00;37.7985144;55.8093419;13681;2315;11366
7:00;37.7992368;55.7947324;6189;1343;4846
7:00;37.8166274;55.7517187;20170;2331;17839
7:00;37.8179174;55.715631;27446;4591;22855
8:00;37.3622257;55.8458623;6918;1235;5683
8:00;37.3824179;55.8356604;1331;415;916
8:00;37.3855554;55.825092;94;1055;-961
8:00;37.4031859;55.8037346;5108;2404;2704
8:00;37.4082585;55.7568353;4554;2650;1904
8:00;37.4169177;55.7408429;7742;5901;1841
8:00;37.4363874;55.860731;10814;2613;8201
8:00;37.4366398;55.8264976;11217;6120;5097
8:00;37.4397991;55.8503173;11835;4364;7471
8:00;37.4459574;55.7308185;1724;1090;634
8:00;37.4460094;55.7307016;4806;2813;1993
8:00;37.4643097;55.8085823;6305;6425;-120
8:00;37.4671944;55.7359279;954;442;512
8:00;37.4707354;55.7296453;6345;5171;1174
8:00;37.4761955;55.8548635;15753;4910;10843
8:00;37.4832383;55.6636112;13782;9527;4255
8:00;37.4834225;55.7394565;1815;1417;398
8:00;37.4865846;55.8400444;6526;5825;701
8:00;37.4937378;55.7933364;7762;7195;567
8:00;37.4978443;55.7436954;1827;1944;-117
8:00;37.4978477;55.8190209;9559;10367;-808
8:00;37.506415;55.6767308;6797;5766;1031
8:00;37.5080944;55.6186964;8630;4317;4313
8:00;37.5148913;55.8049784;3975;7712;-3737
8:00;37.5149237;55.7460754;3803;3434;369
8:00;37.5177438;55.7362565;1275;3025;-1750
8:00;37.5190729;55.6330883;5889;2682;3207
8:00;37.5194078;55.7775074;6229;9538;-3309
8:00;37.5262001;55.6425059;7119;2986;4133
8:00;37.5324136;55.8002374;3782;9254;-5472
8:00;37.5337173;55.6062069;8768;2143;6625
8:00;37.5340698;55.692163;4615;6108;-1493
8:00;37.53429;55.7400038;529;1661;-1132
8:00;37.534383;55.7483228;125;2114;-1989
8:00;37.5401361;55.6567573;3987;10287;-6300
8:00;37.5413387;55.7500562;612;4887;-4275
8:00;37.5464401;55.7735045;5806;9715;-3909
8:00;37.5483675;55.7388362;972;816;156
8:00;37.5528619;55.6016929;1845;415;1430
8:00;37.5547367;55.670291;5694;7110;-1416
8:00;37.5581576;55.7897125;3437;8690;-5253
8:00;37.5591032;55.7103574;186;1154;-968
8:00;37.5615355;55.7645028;3500;12902;-9402
8:00;37.5629779;55.6779484;4449;6548;-2099
8:00;37.5637548;55.7233832;1473;4385;-2912
8:00;37.5660392;55.7444645;10266;7294;2972
8:00;37.5663098;55.7437756;3973;7268;-3295
8:00;37.5736132;55.6878389;5817;6784;-967
8:00;37.5740376;55.8347143;10349;5230;5119
8:00;37.5756626;55.8182119;9343;5056;4287
8:00;37.5768339;55.56931;11019;2442;8577
8:00;37.5773899;55.7605891;1246;4625;-3379
8:00;37.5794779;55.726854;1779;7060;-5281
8:00;37.5798606;55.7609017;712;5170;-4458
8:00;37.5812016;55.8074277;3747;7721;-3974
8:00;37.5822992;55.7473712;1112;7848;-6736
8:00;37.5826348;55.7487722;406;1429;-1023
8:00;37.5837069;55.7766908;3895;5373;-1478
8:00;37.5840306;55.7761643;3804;9998;-6194
8:00;37.5859796;55.7077138;2333;11193;-8860
8:00;37.5873192;55.8978497;13311;3370;9941
8:00;37.5876906;55.7928665;5848;9989;-4141
8:00;37.5898414;55.8472205;2930;3652;-722
8:00;37.5943769;55.7355873;1113;6734;-5621
8:00;37.5943769;55.7355873;0;0;0
8:00;37.5957904;55.7701264;1198;7550;-6352
8:00;37.5964216;55.582549;2769;2104;665
8:00;37.5981698;55.6529571;4621;3219;1402
8:00;37.598314;55.6520286;1693;927;766
8:00;37.6007529;55.7518731;178;1423;-1245
8:00;37.6009269;55.5951773;6231;1610;4621
8:00;37.6020659;55.779514;1413;8407;-6994
8:00;37.6024384;55.8836915;7351;2285;5066
8:00;37.6029929;55.7803918;1006;5816;-4810
8:00;37.6032245;55.7450091;906;6059;-5153
8:00;37.6041499;55.6124609;7990;3721;4269
8:00;37.6048165;55.8634536;12474;3731;8743
8:00;37.6056238;55.7653522;1627;10800;-9173
8:00;37.6056692;55.6627149;3553;3162;391
8:00;37.6066657;55.7508858;134;1995;-1861
8:00;37.6067634;55.64069;6242;3165;3077
8:00;37.6068123;55.7521318;627;6157;-5530
8:00;37.60792;55.7194704;2262;6994;-4732
8:00;37.608832;55.7524514;321;3589;-3268
8:00;37.6091534;55.7295817;864;5089;-4225
8:00;37.6091666;55.622278;5159;3936;1223
8:00;37.6097183;55.7649696;488;5165;-4677
8:00;37.6103732;55.6722659;2030;2689;-659
8:00;37.6118212;55.730075;661;4901;-4240
8:00;37.6150302;55.7813266;707;3191;-2484
8:00;37.61611;55.7953478;2292;5300;-3008
8:00;37.616177;55.7577183;694;8755;-8061
8:00;37.6176267;55.7379525;535;5583;-5048
8:00;37.6187593;55.6533004;8442;9859;-1417
8:00;37.6188598;55.7710979;789;6613;-5824
8:00;37.6202837;55.7685309;264;3638;-3374
8:00;37.621965;55.7566721;336;6296;-5960
8:00;37.6220906;55.7287137;852;4764;-3912
8:00;37.6227483;55.6830582;4240;9123;-4883
8:00;37.6231936;55.7087682;2702;11392;-8690
8:00;37.6248369;55.7274387;1003;6543;-5540
8:00;37.626016;55.7607712;350;8301;-7951
8:00;37.6270765;55.7408687;771;8738;-7967
8:00;37.6279157;55.7598754;374;6173;-5799
8:00;37.6290658;55.7417709;941;8858;-7917
8:00;37.6317458;55.7728672;1200;5203;-4003
8:00;37.6323159;55.7812257;1109;5469;-4360
8:00;37.6331969;55.7797556;1583;7105;-5522
8:00;37.633222;55.7555058;1412;16574;-15162
8:00;37.6361518;55.7933484;2073;3468;-1395
8:00;37.6372552;55.76613;692;7575;-6883
8:00;37.6374183;55.7304321;2163;12825;-10662
8:00;37.63768;55.7317782;3908;9523;-5615
8:00;37.6383529;55.8453055;3012;3821;-809
8:00;37.6387088;55.8086032;3501;8265;-4764
8:00;37.6389332;55.7659277;604;4187;-3583
8:00;37.6398306;55.7668232;203;3431;-3228
8:00;37.6411949;55.8211047;4569;4447;122
8:00;37.6484221;55.768931;1324;9555;-8231
8:00;37.6491378;55.6549517;2753;6913;-4160
8:00;37.6506474;55.7416183;1361;7377;-6016
8:00;37.6519536;55.740344;891;3706;-2815
8:00;37.6526488;55.7413884;1655;6219;-4564
8:00;37.6526672;55.8551422;6054;2642;3412
8:00;37.6545092;55.7748736;7457;5203;2254
8:00;37.656231;55.7754248;28103;4577;23526
8:00;37.6565565;55.6358179;9278;4001;5277
8:00;37.656572;55.7571067;8385;6872;1513
8:00;37.6576183;55.7073699;3058;8363;-5305
8:00;37.658076;55.7581501;10451;5561;4890
8:00;37.6591277;55.7572695;946;3731;-2785
8:00;37.6614511;55.8871576;12425;2636;9789
8:00;37.6638965;55.6784809;9945;7647;2298
8:00;37.6641638;55.8697248;13302;3248;10054
8:00;37.6661457;55.7317659;3401;7723;-4322
8:00;37.6667866;55.7330126;518;2221;-1703
8:00;37.6672754;55.7803946;1814;5946;-4132
8:00;37.6693833;55.6215598;11811;4255;7556
8:00;37.6756382;55.718932;902;3515;-2613
8:00;37.6801346;55.7889129;3275;7071;-3796
8:00;37.6801957;55.7729753;2664;14395;-11731
8:00;37.6820384;55.7464709;5425;4673;752
8:00;37.6822989;55.7457322;3094;4677;-1583
8:00;37.6850483;55.7075562;2165;8038;-5873
8:00;37.6867847;55.7253024;565;6375;-5810
8:00;37.6947891;55.613247;5438;1365;4073
8:00;37.7038734;55.7820537;4178;8086;-3908
8:00;37.7157645;55.7961475;6863;7246;-383
8:00;37.7193262;55.6109687;12286;4800;7486
8:00;37.7200209;55.7520069;5586;11677;-6091
8:00;37.7207673;55.7830875;3014;8321;-5307
8:00;37.7268243;55.6933636;5458;1630;3828
8:00;37.7318594;55.7087389;9001;6867;2134
8:00;37.7344362;55.8146017;6506;3157;3349
8:00;37.7431944;55.6500225;11767;2040;9727
8:00;37.7433398;55.6331579;4564;437;4127
8:00;37.743772;55.621144;3083;405;2678
8:00;37.7445335;55.6137894;8072;1421;6651
8:00;37.7447684;55.8039662;2727;1898;829
8:00;37.7452899;55.61193;2285;299;1986
8:00;37.7498443;55.757225;2254;6052;-3798
8:00;37.7506502;55.6596899;10239;2167;8072
8:00;37.750729;55.788524;1619;2573;-954
8:00;37.7532335;55.6907556;3964;1738;2226
8:00;37.7619338;55.6756254;11060;2772;8288
8:00;37.7657487;55.7055754;15482;4301;11181
8:00;37.7814948;55.787812;4197;1873;2324
8:00;37.7864677;55.751266;11329;3392;7937
8:00;37.7935753;55.7170907;8524;4380;4144
8:00;37.7985144;55.8093419;17608;3597;14011
8:00;37.7992368;55.7947324;9063;3466;5597
8:00;37.8166274;55.7517187;24505;3790;20715
8:00;37.8179174;55.715631;30234;6136;24098
9:00;37.3622257;55.8458623;3861;1238;2623
9:00;37.3824179;55.8356604;888;409;479
9:00;37.3855554;55.825092;139;932;-793
9:00;37.4031859;55.8037346;3081;1808;1273
9:00;37.4082585;55.7568353;3007;2725;282
9:00;37.4169177;55.7408429;5325;4093;1232
9:00;37.4363874;55.860731;7126;2331;4795
9:00;37.4366398;55.8264976;6991;4283;2708
9:00;37.4397991;55.8503173;7714;3559;4155
9:00;37.4459574;55.7308185;1117;814;303
9:00;37.4460094;55.7307016;3418;2263;1155
9:00;37.4643097;55.8085823;4795;4657;138
9:00;37.4671944;55.7359279;641;296;345
9:00;37.4707354;55.7296453;5453;3829;1624
9:00;37.4761955;55.8548635;11240;4123;7117
9:00;37.4832383;55.6636112;10790;7938;2852
9:00;37.4834225;55.7394565;1210;1032;178
9:00;37.4865846;55.8400444;4795;5223;-428
9:00;37.4937378;55.7933364;5598;6843;-1245
9:00;37.4978443;55.7436954;1243;2295;-1052
9:00;37.4978477;55.8190209;7024;8703;-1679
9:00;37.506415;55.6767308;5028;4027;1001
9:00;37.5080944;55.6186964;5254;3595;1659
9:00;37.5148913;55.8049784;3361;7648;-4287
9:00;37.5149237;55.7460754;2523;2108;415
9:00;37.5177438;55.7362565;1192;2448;-1256
9:00;37.5190729;55.6330883;4140;2190;1950
9:00;37.5194078;55.7775074;4562;7378;-2816
9:00;37.5262001;55.6425059;4902;3241;1661
9:00;37.5324136;55.8002374;3347;7844;-4497
9:00;37.5337173;55.6062069;5422;1478;3944
9:00;37.5340698;55.692163;3531;6236;-2705
9:00;37.53429;55.7400038;494;1303;-809
9:00;37.534383;55.7483228;121;1631;-1510
9:00;37.5401361;55.6567573;3331;6922;-3591
9:00;37.5413387;55.7500562;524;4681;-4157
9:00;37.5464401;55.7735045;4402;6633;-2231
9:00;37.5483675;55.7388362;1023;809;214
9:00;37.5528619;55.6016929;1010;262;748
9:00;37.5547367;55.670291;4136;5378;-1242
9:00;37.5581576;55.7897125;2871;6872;-4001
9:00;37.5591032;55.7103574;187;1180;-993
9:00;37.5615355;55.7645028;3125;10718;-7593
9:00;37.5629779;55.6779484;3512;5934;-2422
9:00;37.5637548;55.7233832;1328;3419;-2091
9:00;37.5660392;55.7444645;6849;5584;1265
9:00;37.5663098;55.7437756;3594;7047;-3453
9:00;37.5736132;55.6878389;4399;6309;-1910
9:00;37.5740376;55.8347143;8219;4155;4064
9:00;37.5756626;55.8182119;6392;4760;1632
9:00;37.5768339;55.56931;6573;1892;4681
9:00;37.5773899;55.7605891;1219;3881;-2662
9:00;37.5794779;55.726854;1828;6035;-4207
9:00;37.5798606;55.7609017;762;5297;-4535
9:00;37.5812016;55.8074277;2890;7156;-4266
9:00;37.5822992;55.7473712;1316;7428;-6112
9:00;37.5826348;55.7487722;459;1309;-850
9:00;37.5837069;55.7766908;2952;5305;-2353
9:00;37.5840306;55.7761643;3819;8702;-4883
9:00;37.5859796;55.7077138;2317;9681;-7364
9:00;37.5873192;55.8978497;8373;2557;5816
9:00;37.5876906;55.7928665;4468;9885;-5417
9:00;37.5898414;55.8472205;1966;2763;-797
9:00;37.5943769;55.7355873;1235;6502;-5267
9:00;37.5943769;55.7355873;0;0;0
9:00;37.5957904;55.7701264;1353;7982;-6629
9:00;37.5964216;55.582549;1973;1441;532
9:00;37.5981698;55.6529571;3456;2638;818
9:00;37.598314;55.6520286;1226;799;427
9:00;37.6007529;55.7518731;210;881;-671
9:00;37.6009269;55.5951773;3799;1111;2688
9:00;37.6020659;55.779514;1446;7750;-6304
9:00;37.6024384;55.8836915;4807;1885;2922
9:00;37.6029929;55.7803918;1076;4577;-3501
9:00;37.6032245;55.7450091;1100;6493;-5393
9:00;37.6041499;55.6124609;5392;3358;2034
9:00;37.6048165;55.8634536;8122;3261;4861
9:00;37.6056238;55.7653522;1848;9399;-7551
9:00;37.6056692;55.6627149;2508;2252;256
9:00;37.6066657;55.7508858;210;1446;-1236
9:00;37.6067634;55.64069;4363;2102;2261
9:00;37.6068123;55.7521318;793;4368;-3575
9:00;37.60792;55.7194704;1974;6442;-4468
9:00;37.608832;55.7524514;433;3192;-2759
9:00;37.6091534;55.7295817;1005;5380;-4375
9:00;37.6091666;55.622278;3383;3227;156
9:00;37.6097183;55.7649696;685;3977;-3292
9:00;37.6103732;55.6722659;1464;2112;-648
9:00;37.6118212;55.730075;767;3090;-2323
9:00;37.6150302;55.7813266;570;2499;-1929
9:00;37.61611;55.7953478;1763;4378;-2615
9:00;37.616177;55.7577183;1085;7829;-6744
9:00;37.6176267;55.7379525;777;4454;-3677
9:00;37.6187593;55.6533004;7163;8645;-1482
9:00;37.6188598;55.7710979;950;4906;-3956
9:00;37.6202837;55.7685309;363;2393;-2030
9:00;37.621965;55.7566721;586;4678;-4092
9:00;37.6220906;55.7287137;859;3716;-2857
9:00;37.6227483;55.6830582;3480;6890;-3410
9:00;37.6231936;55.7087682;2343;9725;-7382
9:00;37.6248369;55.7274387;1052;5414;-4362
9:00;37.626016;55.7607712;789;5053;-4264
9:00;37.6270765;55.7408687;1057;6584;-5527
9:00;37.6279157;55.7598754;567;3596;-3029
9:00;37.6290658;55.7417709;1235;6584;-5349
9:00;37.6317458;55.7728672;1178;4338;-3160
9:00;37.6323159;55.7812257;1219;4529;-3310
9:00;37.6331969;55.7797556;1604;5328;-3724
9:00;37.633222;55.7555058;2054;12663;-10609
9:00;37.6361518;55.7933484;1663;2672;-1009
9:00;37.6372552;55.76613;915;4640;-3725
9:00;37.6374183;55.7304321;2298;10571;-8273
9:00;37.63768;55.7317782;3414;7591;-4177
9:00;37.6383529;55.8453055;2187;3170;-983
9:00;37.6387088;55.8086032;2804;7841;-5037
9:00;37.6389332;55.7659277;697;3432;-2735
9:00;37.6398306;55.7668232;279;1800;-1521
9:00;37.6411949;55.8211047;2592;3326;-734
9:00;37.6484221;55.768931;1484;6201;-4717
9:00;37.6491378;55.6549517;2171;5212;-3041
9:00;37.6506474;55.7416183;1328;6045;-4717
9:00;37.6519536;55.740344;761;2679;-1918
9:00;37.6526488;55.7413884;1725;6044;-4319
9:00;37.6526672;55.8551422;3916;2151;1765
9:00;37.6545092;55.7748736;4941;3034;1907
9:00;37.656231;55.7754248;23411;3503;19908
9:00;37.6565565;55.6358179;7295;3108;4187
9:00;37.656572;55.7571067;6118;5736;382
9:00;37.6576183;55.7073699;2679;8986;-6307
9:00;37.658076;55.7581501;6801;5453;1348
9:00;37.6591277;55.7572695;956;4034;-3078
9:00;37.6614511;55.8871576;8476;2086;6390
9:00;37.6638965;55.6784809;7044;4911;2133
9:00;37.6641638;55.8697248;8536;2979;5557
9:00;37.6661457;55.7317659;3039;6800;-3761
9:00;37.6667866;55.7330126;359;1787;-1428
9:00;37.6672754;55.7803946;1630;4127;-2497
9:00;37.6693833;55.6215598;8440;2751;5689
9:00;37.6756382;55.718932;881;3203;-2322
9:00;37.6801346;55.7889129;2530;5376;-2846
9:00;37.6801957;55.7729753;2578;12321;-9743
9:00;37.6820384;55.7464709;3888;3838;50
9:00;37.6822989;55.7457322;2188;3445;-1257
9:00;37.6850483;55.7075562;1706;4616;-2910
9:00;37.6867847;55.7253024;775;5294;-4519
9:00;37.6947891;55.613247;3488;1014;2474
9:00;37.7038734;55.7820537;3103;7413;-4310
9:00;37.7157645;55.7961475;5003;6553;-1550
9:00;37.7193262;55.6109687;8875;4145;4730
9:00;37.7200209;55.7520069;4083;8963;-4880
9:00;37.7207673;55.7830875;2447;7094;-4647
9:00;37.7268243;55.6933636;3509;1240;2269
9:00;37.7318594;55.7087389;6392;4703;1689
9:00;37.7344362;55.8146017;3882;2473;1409
9:00;37.7431944;55.6500225;6775;2022;4753
9:00;37.7433398;55.6331579;2225;354;1871
9:00;37.743772;55.621144;1746;366;1380
9:00;37.7445335;55.6137894;5081;1158;3923
9:00;37.7447684;55.8039662;2017;1506;511
9:00;37.7452899;55.61193;1166;256;910
9:00;37.7498443;55.757225;1796;4788;-2992
9:00;37.7506502;55.6596899;6142;2255;3887
9:00;37.750729;55.788524;1816;1950;-134
9:00;37.7532335;55.6907556;2421;1140;1281
9:00;37.7619338;55.6756254;6853;2268;4585
9:00;37.7657487;55.7055754;11419;3612;7807
9:00;37.7814948;55.787812;2991;1618;1373
9:00;37.7864677;55.751266;7062;3158;3904
9:00;37.7935753;55.7170907;6445;3727;2718
9:00;37.7985144;55.8093419;12487;3349;9138
9:00;37.7992368;55.7947324;6027;3319;2708
9:00;37.8166274;55.7517187;17824;3094;14730
9:00;37.8179174;55.715631;22960;5390;17570
10:00;37.3622257;55.8458623;2124;1038;1086
10:00;37.3824179;55.8356604;490;283;207
10:00;37.3855554;55.825092;121;507;-386
10:00;37.4031859;55.8037346;1724;1204;520
10:00;37.4082585;55.7568353;1760;1784;-24
10:00;37.4169177;55.7408429;3056;2719;337
10:00;37.4363874;55.860731;3628;1901;1727
10:00;37.4366398;55.8264976;4700;2957;1743
10:00;37.4397991;55.8503173;4369;2676;1693
10:00;37.4459574;55.7308185;754;550;204
10:00;37.4460094;55.7307016;1739;1301;438
10:00;37.4643097;55.8085823;3203;3145;58
10:00;37.4671944;55.7359279;440;301;139
10:00;37.4707354;55.7296453;3144;2515;629
10:00;37.4761955;55.8548635;6363;3028;3335
10:00;37.4832383;55.6636112;6404;5490;914
10:00;37.4834225;55.7394565;814;831;-17
10:00;37.4865846;55.8400444;3023;3199;-176
10:00;37.4937378;55.7933364;3485;4401;-916
10:00;37.4978443;55.7436954;955;1779;-824
10:00;37.4978477;55.8190209;4437;5524;-1087
10:00;37.506415;55.6767308;2955;2684;271
10:00;37.5080944;55.6186964;4284;2610;1674
10:00;37.5148913;55.8049784;2656;4618;-1962
10:00;37.5149237;55.7460754;1615;1370;245
10:00;37.5177438;55.7362565;941;1388;-447
10:00;37.5190729;55.6330883;2555;1809;746
10:00;37.5194078;55.7775074;3250;4451;-1201
10:00;37.5262001;55.6425059;3058;2581;477
10:00;37.5324136;55.8002374;2576;5339;-2763
10:00;37.5337173;55.6062069;3033;1303;1730
10:00;37.5340698;55.692163;2533;4278;-1745
10:00;37.53429;55.7400038;467;802;-335
10:00;37.534383;55.7483228;165;689;-524
10:00;37.5401361;55.6567573;2441;4157;-1716
10:00;37.5413387;55.7500562;401;2331;-1930
10:00;37.5464401;55.7735045;2771;3409;-638
10:00;37.5483675;55.7388362;601;670;-69
10:00;37.5528619;55.6016929;601;258;343
10:00;37.5547367;55.670291;2818;3226;-408
10:00;37.5581576;55.7897125;2256;3752;-1496
10:00;37.5591032;55.7103574;187;806;-619
10:00;37.5615355;55.7645028;2748;6773;-4025
10:00;37.5629779;55.6779484;2692;4025;-1333
10:00;37.5637548;55.7233832;1246;2123;-877
10:00;37.5660392;55.7444645;3303;3168;135
10:00;37.5663098;55.7437756;2777;4349;-1572
10:00;37.5736132;55.6878389;2976;4102;-1126
10:00;37.5740376;55.8347143;5199;2949;2250
10:00;37.5756626;55.8182119;4104;2918;1186
10:00;37.5768339;55.56931;3497;1606;1891
10:00;37.5773899;55.7605891;1033;2362;-1329
10:00;37.5794779;55.726854;1667;3710;-2043
10:00;37.5798606;55.7609017;1045;2990;-1945
10:00;37.5812016;55.8074277;1996;3515;-1519
10:00;37.5822992;55.7473712;1350;4324;-2974
10:00;37.5826348;55.7487722;401;961;-560
10:00;37.5837069;55.7766908;2080;2868;-788
10:00;37.5840306;55.7761643;3082;5045;-1963
10:00;37.5859796;55.7077138;2085;6182;-4097
10:00;37.5873192;55.8978497;4358;1875;2483
10:00;37.5876906;55.7928665;3459;5515;-2056
10:00;37.5898414;55.8472205;1295;1623;-328
10:00;37.5943769;55.7355873;1423;4349;-2926
10:00;37.5943769;55.7355873;0;0;0
10:00;37.5957904;55.7701264;1682;5118;-3436
10:00;37.5964216;55.582549;1259;853;406
10:00;37.5981698;55.6529571;2115;1622;493
10:00;37.598314;55.6520286;667;502;165
10:00;37.6007529;55.7518731;252;675;-423
10:00;37.6009269;55.5951773;2028;825;1203
10:00;37.6020659;55.779514;1858;5540;-3682
10:00;37.6024384;55.8836915;2535;1439;1096
10:00;37.6029929;55.7803918;1161;3214;-2053
10:00;37.6032245;55.7450091;1233;4223;-2990
10:00;37.6041499;55.6124609;3199;2386;813
10:00;37.6048165;55.8634536;4319;2240;2079
10:00;37.6056238;55.7653522;2111;6715;-4604
10:00;37.6056692;55.6627149;1646;1536;110
10:00;37.6066657;55.7508858;159;795;-636
10:00;37.6067634;55.64069;2472;1624;848
10:00;37.6068123;55.7521318;840;2986;-2146
10:00;37.60792;55.7194704;1706;3978;-2272
10:00;37.608832;55.7524514;575;1970;-1395
10:00;37.6091534;55.7295817;1183;3458;-2275
10:00;37.6091666;55.622278;2006;1993;13
10:00;37.6097183;55.7649696;861;2877;-2016
10:00;37.6103732;55.6722659;988;1247;-259
10:00;37.6118212;55.730075;757;1747;-990
10:00;37.6150302;55.7813266;476;1284;-808
10:00;37.61611;55.7953478;1263;2462;-1199
10:00;37.616177;55.7577183;1555;5691;-4136
10:00;37.6176267;55.7379525;847;2684;-1837
10:00;37.6187593;55.6533004;5150;5459;-309
10:00;37.6188598;55.7710979;1102;3277;-2175
10:00;37.6202837;55.7685309;451;1353;-902
10:00;37.621965;55.7566721;646;2728;-2082
10:00;37.6220906;55.7287137;950;2200;-1250
10:00;37.6227483;55.6830582;1969;3431;-1462
10:00;37.6231936;55.7087682;2269;5600;-3331
10:00;37.6248369;55.7274387;1037;2711;-1674
10:00;37.626016;55.7607712;1088;3005;-1917
10:00;37.6270765;55.7408687;1192;4246;-3054
10:00;37.6279157;55.7598754;825;2301;-1476
10:00;37.6290658;55.7417709;1473;4186;-2713
10:00;37.6317458;55.7728672;1268;3100;-1832
10:00;37.6323159;55.7812257;1375;2796;-1421
10:00;37.6331969;55.7797556;1637;3263;-1626
10:00;37.633222;55.7555058;2501;7488;-4987
10:00;37.6361518;55.7933484;1306;1752;-446
10:00;37.6372552;55.76613;974;2605;-1631
10:00;37.6374183;55.7304321;2370;5522;-3152
10:00;37.63768;55.7317782;3089;4332;-1243
10:00;37.6383529;55.8453055;1407;1939;-532
10:00;37.6387088;55.8086032;2242;4245;-2003
10:00;37.6389332;55.7659277;955;2468;-1513
10:00;37.6398306;55.7668232;242;941;-699
10:00;37.6411949;55.8211047;1778;2097;-319
10:00;37.6484221;55.768931;1692;3831;-2139
10:00;37.6491378;55.6549517;1972;3235;-1263
10:00;37.6506474;55.7416183;1383;3791;-2408
10:00;37.6519536;55.740344;708;1526;-818
10:00;37.6526488;55.7413884;1594;3863;-2269
10:00;37.6526672;55.8551422;2509;1467;1042
10:00;37.6545092;55.7748736;3329;1890;1439
10:00;37.656231;55.7754248;11323;2955;8368
10:00;37.6565565;55.6358179;4107;2228;1879
10:00;37.656572;55.7571067;3474;3759;-285
10:00;37.6576183;55.7073699;2382;5442;-3060
10:00;37.658076;55.7581501;4294;3369;925
10:00;37.6591277;55.7572695;1117;2687;-1570
10:00;37.6614511;55.8871576;4389;1768;2621
10:00;37.6638965;55.6784809;4260;3313;947
10:00;37.6641638;55.8697248;4264;2117;2147
10:00;37.6661457;55.7317659;2291;3909;-1618
10:00;37.6667866;55.7330126;290;764;-474
10:00;37.6672754;55.7803946;1462;2462;-1000
10:00;37.6693833;55.6215598;4711;2266;2445
10:00;37.6756382;55.718932;723;2068;-1345
10:00;37.6801346;55.7889129;2013;3299;-1286
10:00;37.6801957;55.7729753;2684;7398;-4714
10:00;37.6820384;55.7464709;1991;2287;-296
10:00;37.6822989;55.7457322;1257;2010;-753
10:00;37.6850483;55.7075562;1281;2241;-960
10:00;37.6867847;55.7253024;1035;3126;-2091
10:00;37.6947891;55.613247;1944;907;1037
10:00;37.7038734;55.7820537;2172;3883;-1711
10:00;37.7157645;55.7961475;3325;4040;-715
10:00;37.7193262;55.6109687;5395;2897;2498
10:00;37.7200209;55.7520069;2748;4840;-2092
10:00;37.7207673;55.7830875;2103;4005;-1902
10:00;37.7268243;55.6933636;1818;948;870
10:00;37.7318594;55.7087389;4110;3337;773
10:00;37.7344362;55.8146017;2010;1536;474
10:00;37.7431944;55.6500225;3556;1686;1870
10:00;37.7433398;55.6331579;1141;394;747
10:00;37.743772;55.621144;918;332;586
10:00;37.7445335;55.6137894;2751;1024;1727
10:00;37.7447684;55.8039662;1094;995;99
10:00;37.7452899;55.61193;558;236;322
10:00;37.7498443;55.757225;1558;2589;-1031
10:00;37.7506502;55.6596899;3231;1698;1533
10:00;37.750729;55.788524;1127;1247;-120
10:00;37.7532335;55.6907556;1373;874;499
10:00;37.7619338;55.6756254;3500;1959;1541
10:00;37.7657487;55.7055754;6872;2918;3954
10:00;37.7814948;55.787812;1742;1359;383
10:00;37.7864677;55.751266;3805;2120;1685
10:00;37.7935753;55.7170907;3912;2541;1371
10:00;37.7985144;55.8093419;6630;2703;3927
10:00;37.7992368;55.7947324;3550;2188;1362
10:00;37.8166274;55.7517187;8662;2599;6063
10:00;37.8179174;55.715631;11359;4577;6782
11:00;37.3622257;55.8458623;1670;907;763
11:00;37.3824179;55.8356604;354;258;96
11:00;37.3855554;55.825092;225;225;0
11:00;37.4031859;55.8037346;1260;985;275
11:00;37.4082585;55.7568353;1493;1299;194
11:00;37.4169177;55.7408429;2811;2150;661
11:00;37.4363874;55.860731;2964;1800;1164
11:00;37.4366398;55.8264976;3893;2350;1543
11:00;37.4397991;55.8503173;3637;2455;1182
11:00;37.4459574;55.7308185;657;605;52
11:00;37.4460094;55.7307016;1334;967;367
11:00;37.4643097;55.8085823;2715;2466;249
11:00;37.4671944;55.7359279;410;331;79
11:00;37.4707354;55.7296453;2295;1723;572
11:00;37.4761955;55.8548635;4561;2929;1632
11:00;37.4832383;55.6636112;5422;4427;995
11:00;37.4834225;55.7394565;742;726;16
11:00;37.4865846;55.8400444;2622;2438;184
11:00;37.4937378;55.7933364;2919;3256;-337
11:00;37.4978443;55.7436954;1167;1507;-340
11:00;37.4978477;55.8190209;4007;4229;-222
11:00;37.506415;55.6767308;2399;2023;376
11:00;37.5080944;55.6186964;3327;2567;760
11:00;37.5148913;55.8049784;2703;3418;-715
11:00;37.5149237;55.7460754;1311;1184;127
11:00;37.5177438;55.7362565;853;918;-65
11:00;37.5190729;55.6330883;2167;1601;566
11:00;37.5194078;55.7775074;2777;3064;-287
11:00;37.5262001;55.6425059;2617;2224;393
11:00;37.5324136;55.8002374;2511;3816;-1305
11:00;37.5337173;55.6062069;2342;1383;959
11:00;37.5340698;55.692163;2354;3188;-834
11:00;37.53429;55.7400038;490;593;-103
11:00;37.534383;55.7483228;236;400;-164
11:00;37.5401361;55.6567573;2442;3012;-570
11:00;37.5413387;55.7500562;486;1365;-879
11:00;37.5464401;55.7735045;2595;2358;237
11:00;37.5483675;55.7388362;743;583;160
11:00;37.5528619;55.6016929;480;316;164
11:00;37.5547367;55.670291;2567;2611;-44
11:00;37.5581576;55.7897125;2193;2374;-181
11:00;37.5591032;55.7103574;208;484;-276
11:00;37.5615355;55.7645028;2940;4348;-1408
11:00;37.5629779;55.6779484;2484;3014;-530
11:00;37.5637548;55.7233832;1337;1507;-170
11:00;37.5660392;55.7444645;2888;2590;298
11:00;37.5663098;55.7437756;2875;3543;-668
11:00;37.5736132;55.6878389;2563;2885;-322
11:00;37.5740376;55.8347143;3882;2586;1296
11:00;37.5756626;55.8182119;2610;2257;353
11:00;37.5768339;55.56931;2660;1600;1060
11:00;37.5773899;55.7605891;1081;1591;-510
11:00;37.5794779;55.726854;1845;2905;-1060
11:00;37.5798606;55.7609017;1263;2179;-916
11:00;37.5812016;55.8074277;1942;2260;-318
11:00;37.5822992;55.7473712;1530;2978;-1448
11:00;37.5826348;55.7487722;437;647;-210
11:00;37.5837069;55.7766908;1820;2037;-217
11:00;37.5840306;55.7761643;3015;3466;-451
11:00;37.5859796;55.7077138;2274;4266;-1992
11:00;37.5873192;55.8978497;3177;1801;1376
11:00;37.5876906;55.7928665;2681;3900;-1219
11:00;37.5898414;55.8472205;1263;1179;84
11:00;37.5943769;55.7355873;1527;2944;-1417
11:00;37.5943769;55.7355873;0;0;0
11:00;37.5957904;55.7701264;1963;3306;-1343
11:00;37.5964216;55.582549;992;647;345
11:00;37.5981698;55.6529571;1732;1452;280
11:00;37.598314;55.6520286;528;502;26
11:00;37.6007529;55.7518731;307;541;-234
11:00;37.6009269;55.5951773;1615;849;766
11:00;37.6020659;55.779514;2124;3552;-1428
11:00;37.6024384;55.8836915;1882;1380;502
11:00;37.6029929;55.7803918;1384;2180;-796
11:00;37.6032245;55.7450091;1514;3238;-1724
11:00;37.6041499;55.6124609;2775;2235;540
11:00;37.6048165;55.8634536;3188;2179;1009
11:00;37.6056238;55.7653522;2534;5134;-2600
11:00;37.6056692;55.6627149;1251;1204;47
11:00;37.6066657;55.7508858;215;587;-372
11:00;37.6067634;55.64069;2059;1395;664
11:00;37.6068123;55.7521318;1168;2321;-1153
11:00;37.60792;55.7194704;1771;2581;-810
11:00;37.608832;55.7524514;651;1321;-670
11:00;37.6091534;55.7295817;1445;2605;-1160
11:00;37.6091666;55.622278;1762;1649;113
11:00;37.6097183;55.7649696;892;2012;-1120
11:00;37.6103732;55.6722659;839;850;-11
11:00;37.6118212;55.730075;809;1291;-482
11:00;37.6150302;55.7813266;554;801;-247
11:00;37.61611;55.7953478;1156;1638;-482
11:00;37.616177;55.7577183;2059;4428;-2369
11:00;37.6176267;55.7379525;1112;1870;-758
11:00;37.6187593;55.6533004;4281;4547;-266
11:00;37.6188598;55.7710979;1290;2466;-1176
11:00;37.6202837;55.7685309;457;852;-395
11:00;37.621965;55.7566721;853;1996;-1143
11:00;37.6220906;55.7287137;1082;1632;-550
11:00;37.6227483;55.6830582;1892;2163;-271
11:00;37.6231936;55.7087682;2602;4021;-1419
11:00;37.6248369;55.7274387;1323;1920;-597
11:00;37.626016;55.7607712;1411;2150;-739
11:00;37.6270765;55.7408687;1362;3022;-1660
11:00;37.6279157;55.7598754;1019;1779;-760
11:00;37.6290658;55.7417709;1732;3113;-1381
11:00;37.6317458;55.7728672;1505;2321;-816
11:00;37.6323159;55.7812257;1668;2152;-484
11:00;37.6331969;55.7797556;1770;2368;-598
11:00;37.633222;55.7555058;2922;5531;-2609
11:00;37.6361518;55.7933484;1317;1485;-168
11:00;37.6372552;55.76613;1062;1881;-819
11:00;37.6374183;55.7304321;2499;3603;-1104
11:00;37.63768;55.7317782;2517;2707;-190
11:00;37.6383529;55.8453055;1288;1406;-118
11:00;37.6387088;55.8086032;2292;3085;-793
11:00;37.6389332;55.7659277;1041;1955;-914
11:00;37.6398306;55.7668232;275;644;-369
11:00;37.6411949;55.8211047;1835;1702;133
11:00;37.6484221;55.768931;1935;2651;-716
11:00;37.6491378;55.6549517;2108;2377;-269
11:00;37.6506474;55.7416183;1613;2742;-1129
11:00;37.6519536;55.740344;732;1068;-336
11:00;37.6526488;55.7413884;1850;2883;-1033
11:00;37.6526672;55.8551422;1674;1404;270
11:00;37.6545092;55.7748736;2376;1699;677
11:00;37.656231;55.7754248;6617;2715;3902
11:00;37.6565565;55.6358179;3242;1971;1271
11:00;37.656572;55.7571067;2456;2720;-264
11:00;37.6576183;55.7073699;2383;3774;-1391
11:00;37.658076;55.7581501;2659;2605;54
11:00;37.6591277;55.7572695;1217;1972;-755
11:00;37.6614511;55.8871576;3107;1557;1550
11:00;37.6638965;55.6784809;3423;2770;653
11:00;37.6641638;55.8697248;3224;1820;1404
11:00;37.6661457;55.7317659;2166;2780;-614
11:00;37.6667866;55.7330126;289;533;-244
11:00;37.6672754;55.7803946;1497;1871;-374
11:00;37.6693833;55.6215598;3969;2132;1837
11:00;37.6756382;55.718932;819;1355;-536
11:00;37.6801346;55.7889129;2041;2467;-426
11:00;37.6801957;55.7729753;3204;4990;-1786
11:00;37.6820384;55.7464709;1540;1545;-5
11:00;37.6822989;55.7457322;1173;1342;-169
11:00;37.6850483;55.7075562;1190;1532;-342
11:00;37.6867847;55.7253024;1295;1933;-638
11:00;37.6947891;55.613247;1380;836;544
11:00;37.7038734;55.7820537;2056;2616;-560
11:00;37.7157645;55.7961475;2839;3031;-192
11:00;37.7193262;55.6109687;4562;2788;1774
11:00;37.7200209;55.7520069;2874;3500;-626
11:00;37.7207673;55.7830875;2140;2862;-722
11:00;37.7268243;55.6933636;1323;897;426
11:00;37.7318594;55.7087389;2933;2628;305
11:00;37.7344362;55.8146017;1582;1254;328
11:00;37.7431944;55.6500225;2621;1711;910
11:00;37.7433398;55.6331579;825;386;439
11:00;37.743772;55.621144;698;324;374
11:00;37.7445335;55.6137894;1942;1079;863
11:00;37.7447684;55.8039662;960;846;114
11:00;37.7452899;55.61193;409;234;175
11:00;37.7498443;55.757225;1496;1714;-218
11:00;37.7506502;55.6596899;2390;1854;536
11:00;37.750729;55.788524;1090;959;131
11:00;37.7532335;55.6907556;1036;651;385
11:00;37.7619338;55.6756254;2918;2075;843
11:00;37.7657487;55.7055754;5031;2779;2252
11:00;37.7814948;55.787812;1538;1404;134
11:00;37.7864677;55.751266;2919;1875;1044
11:00;37.7935753;55.7170907;3071;2367;704
11:00;37.7985144;55.8093419;4931;2375;2556
11:00;37.7992368;55.7947324;2692;1938;754
11:00;37.8166274;55.7517187;5943;2571;3372
11:00;37.8179174;55.715631;8044;4319;3725
12:00;37.3622257;55.8458623;1516;1023;493
12:00;37.3824179;55.8356604;319;240;79
12:00;37.3855554;55.825092;172;206;-34
12:00;37.4031859;55.8037346;1313;996;317
12:00;37.4082585;55.7568353;1402;1188;214
12:00;37.4169177;55.7408429;2621;2106;515
12:00;37.4363874;55.860731;2672;1920;752
12:00;37.4366398;55.8264976;3168;2334;834
12:00;37.4397991;55.8503173;3291;2438;853
12:00;37.4459574;55.7308185;677;631;46
12:00;37.4460094;55.7307016;1251;914;337
12:00;37.4643097;55.8085823;2695;2574;121
12:00;37.4671944;55.7359279;419;357;62
12:00;37.4707354;55.7296453;2222;1668;554
12:00;37.4761955;55.8548635;4407;3031;1376
12:00;37.4832383;55.6636112;5323;4032;1291
12:00;37.4834225;55.7394565;766;827;-61
12:00;37.4865846;55.8400444;2644;2354;290
12:00;37.4937378;55.7933364;2876;3037;-161
12:00;37.4978443;55.7436954;1416;1505;-89
12:00;37.4978477;55.8190209;4031;4055;-24
12:00;37.506415;55.6767308;2378;1922;456
12:00;37.5080944;55.6186964;3300;2651;649
12:00;37.5148913;55.8049784;2770;3035;-265
12:00;37.5149237;55.7460754;1469;1081;388
12:00;37.5177438;55.7362565;961;775;186
12:00;37.5190729;55.6330883;2125;1707;418
12:00;37.5194078;55.7775074;2908;2889;19
12:00;37.5262001;55.6425059;2564;2207;357
12:00;37.5324136;55.8002374;2755;2970;-215
12:00;37.5337173;55.6062069;2107;1530;577
12:00;37.5340698;55.692163;2562;2873;-311
12:00;37.53429;55.7400038;530;532;-2
12:00;37.534383;55.7483228;254;315;-61
12:00;37.5401361;55.6567573;2563;2617;-54
12:00;37.5413387;55.7500562;710;1014;-304
12:00;37.5464401;55.7735045;2537;2024;513
12:00;37.5483675;55.7388362;529;529;0
12:00;37.5528619;55.6016929;447;311;136
12:00;37.5547367;55.670291;2495;2569;-74
12:00;37.5581576;55.7897125;2300;2052;248
12:00;37.5591032;55.7103574;267;377;-110
12:00;37.5615355;55.7645028;3194;3598;-404
12:00;37.5629779;55.6779484;2446;2837;-391
12:00;37.5637548;55.7233832;1309;1318;-9
12:00;37.5660392;55.7444645;2264;2398;-134
12:00;37.5663098;55.7437756;2966;3196;-230
12:00;37.5736132;55.6878389;2667;2785;-118
12:00;37.5740376;55.8347143;3673;2620;1053
12:00;37.5756626;55.8182119;2442;2225;217
12:00;37.5768339;55.56931;2434;1688;746
12:00;37.5773899;55.7605891;1170;1369;-199
12:00;37.5794779;55.726854;2240;2362;-122
12:00;37.5798606;55.7609017;1393;1953;-560
12:00;37.5812016;55.8074277;1650;1902;-252
12:00;37.5822992;55.7473712;1689;2316;-627
12:00;37.5826348;55.7487722;556;625;-69
12:00;37.5837069;55.7766908;1844;1755;89
12:00;37.5840306;55.7761643;2975;2985;-10
12:00;37.5859796;55.7077138;2616;3632;-1016
12:00;37.5873192;55.8978497;2785;1951;834
12:00;37.5876906;55.7928665;2833;3516;-683
12:00;37.5898414;55.8472205;1186;1064;122
12:00;37.5943769;55.7355873;1817;2661;-844
12:00;37.5943769;55.7355873;0;0;0
12:00;37.5957904;55.7701264;2299;2853;-554
12:00;37.5964216;55.582549;1060;655;405
12:00;37.5981698;55.6529571;1516;1417;99
12:00;37.598314;55.6520286;507;518;-11
12:00;37.6007529;55.7518731;359;475;-116
12:00;37.6009269;55.5951773;1482;936;546
12:00;37.6020659;55.779514;2729;3020;-291
12:00;37.6024384;55.8836915;1745;1345;400
12:00;37.6029929;55.7803918;1546;1811;-265
12:00;37.6032245;55.7450091;1860;2610;-750
12:00;37.6041499;55.6124609;2724;2315;409
12:00;37.6048165;55.8634536;2667;2284;383
12:00;37.6056238;55.7653522;2890;4125;-1235
12:00;37.6056692;55.6627149;1268;1150;118
12:00;37.6066657;55.7508858;268;460;-192
12:00;37.6067634;55.64069;1736;1540;196
12:00;37.6068123;55.7521318;1284;1975;-691
12:00;37.60792;55.7194704;1876;2053;-177
12:00;37.608832;55.7524514;857;1162;-305
12:00;37.6091534;55.7295817;1795;2221;-426
12:00;37.6091666;55.622278;1627;1612;15
12:00;37.6097183;55.7649696;1058;1615;-557
12:00;37.6103732;55.6722659;807;825;-18
12:00;37.6118212;55.730075;932;1147;-215
12:00;37.6150302;55.7813266;600;668;-68
12:00;37.61611;55.7953478;1210;1299;-89
12:00;37.616177;55.7577183;2833;4155;-1322
12:00;37.6176267;55.7379525;1206;1669;-463
12:00;37.6187593;55.6533004;4848;4078;770
12:00;37.6188598;55.7710979;1615;1920;-305
12:00;37.6202837;55.7685309;532;731;-199
12:00;37.621965;55.7566721;977;1661;-684
12:00;37.6220906;55.7287137;1347;1425;-78
12:00;37.6227483;55.6830582;1529;1947;-418
12:00;37.6231936;55.7087682;2897;3430;-533
12:00;37.6248369;55.7274387;1428;1546;-118
12:00;37.626016;55.7607712;1534;1895;-361
12:00;37.6270765;55.7408687;1693;2575;-882
12:00;37.6279157;55.7598754;1413;1644;-231
12:00;37.6290658;55.7417709;2006;2620;-614
12:00;37.6317458;55.7728672;1686;1977;-291
12:00;37.6323159;55.7812257;1753;1860;-107
12:00;37.6331969;55.7797556;2083;2214;-131
12:00;37.633222;55.7555058;3663;4517;-854
12:00;37.6361518;55.7933484;1227;1425;-198
12:00;37.6372552;55.76613;1217;1544;-327
12:00;37.6374183;55.7304321;2638;3131;-493
12:00;37.63768;55.7317782;2080;2380;-300
12:00;37.6383529;55.8453055;1321;1190;131
12:00;37.6387088;55.8086032;2422;2499;-77
12:00;37.6389332;55.7659277;1277;1546;-269
12:00;37.6398306;55.7668232;332;562;-230
12:00;37.6411949;55.8211047;1671;1633;38
12:00;37.6484221;55.768931;2160;2289;-129
12:00;37.6491378;55.6549517;2193;2165;28
12:00;37.6506474;55.7416183;2157;2345;-188
12:00;37.6519536;55.740344;837;982;-145
12:00;37.6526488;55.7413884;2093;2621;-528
12:00;37.6526672;55.8551422;1593;1253;340
12:00;37.6545092;55.7748736;1490;1650;-160
12:00;37.656231;55.7754248;3332;3290;42
12:00;37.6565565;55.6358179;2878;2152;726
12:00;37.656572;55.7571067;1562;2600;-1038
12:00;37.6576183;55.7073699;2624;3003;-379
12:00;37.658076;55.7581501;1912;2294;-382
12:00;37.6591277;55.7572695;1366;1723;-357
12:00;37.6614511;55.8871576;2772;1774;998
12:00;37.6638965;55.6784809;3054;2846;208
12:00;37.6641638;55.8697248;2779;2005;774
12:00;37.6661457;55.7317659;2183;2462;-279
12:00;37.6667866;55.7330126;337;435;-98
12:00;37.6672754;55.7803946;1547;1814;-267
12:00;37.6693833;55.6215598;2952;2078;874
12:00;37.6756382;55.718932;997;1190;-193
12:00;37.6801346;55.7889129;2295;2203;92
12:00;37.6801957;55.7729753;3616;3841;-225
12:00;37.6820384;55.7464709;1119;1453;-334
12:00;37.6822989;55.7457322;981;1311;-330
12:00;37.6850483;55.7075562;1414;1382;32
12:00;37.6867847;55.7253024;1421;1459;-38
12:00;37.6947891;55.613247;1238;953;285
12:00;37.7038734;55.7820537;1758;2170;-412
12:00;37.7157645;55.7961475;2992;2683;309
12:00;37.7193262;55.6109687;3597;2810;787
12:00;37.7200209;55.7520069;2865;2979;-114
12:00;37.7207673;55.7830875;2573;2474;99
12:00;37.7268243;55.6933636;1265;926;339
12:00;37.7318594;55.7087389;3128;2511;617
12:00;37.7344362;55.8146017;1513;1201;312
12:00;37.7431944;55.6500225;2291;1826;465
12:00;37.7433398;55.6331579;642;419;223
12:00;37.743772;55.621144;581;396;185
12:00;37.7445335;55.6137894;1729;1322;407
12:00;37.7447684;55.8039662;970;852;118
12:00;37.7452899;55.61193;365;290;75
12:00;37.7498443;55.757225;1585;1445;140
12:00;37.7506502;55.6596899;2333;1810;523
12:00;37.750729;55.788524;1091;796;295
12:00;37.7532335;55.6907556;968;746;222
12:00;37.7619338;55.6756254;2713;1999;714
12:00;37.7657487;55.7055754;4142;3047;1095
12:00;37.7814948;55.787812;1512;1278;234
12:00;37.7864677;55.751266;2546;1901;645
12:00;37.7935753;55.7170907;2870;2331;539
12:00;37.7985144;55.8093419;4360;2671;1689
12:00;37.7992368;55.7947324;2599;1961;638
12:00;37.8166274;55.7517187;4878;2993;1885
12:00;37.8179174;55.715631;6335;4911;1424
13:00;37.3622257;55.8458623;1368;1085;283
13:00;37.3824179;55.8356604;335;260;75
13:00;37.3855554;55.825092;196;140;56
13:00;37.4031859;55.8037346;1284;990;294
13:00;37.4082585;55.7568353;1344;1235;109
13:00;37.4169177;55.7408429;2722;2051;671
13:00;37.4363874;55.860731;2620;2164;456
13:00;37.4366398;55.8264976;3552;2558;994
13:00;37.4397991;55.8503173;3006;2597;409
13:00;37.4459574;55.7308185;631;647;-16
13:00;37.4460094;55.7307016;1116;967;149
13:00;37.4643097;55.8085823;2870;2581;289
13:00;37.4671944;55.7359279;391;344;47
13:00;37.4707354;55.7296453;2242;1708;534
13:00;37.4761955;55.8548635;3936;3171;765
13:00;37.4832383;55.6636112;5559;4076;1483
13:00;37.4834225;55.7394565;752;784;-32
13:00;37.4865846;55.8400444;2766;2302;464
13:00;37.4937378;55.7933364;2929;2838;91
13:00;37.4978443;55.7436954;1445;1462;-17
13:00;37.4978477;55.8190209;4310;4020;290
13:00;37.506415;55.6767308;2339;2201;138
13:00;37.5080944;55.6186964;3349;2667;682
13:00;37.5148913;55.8049784;3025;2823;202
13:00;37.5149237;55.7460754;1012;1317;-305
13:00;37.5177438;55.7362565;1079;871;208
13:00;37.5190729;55.6330883;2122;1695;427
13:00;37.5194078;55.7775074;3099;2781;318
13:00;37.5262001;55.6425059;2626;2407;219
13:00;37.5324136;55.8002374;3128;3078;50
13:00;37.5337173;55.6062069;2024;1745;279
13:00;37.5340698;55.692163;2959;2913;46
13:00;37.53429;55.7400038;565;580;-15
13:00;37.534383;55.7483228;265;306;-41
13:00;37.5401361;55.6567573;2489;2516;-27
13:00;37.5413387;55.7500562;826;948;-122
13:00;37.5464401;55.7735045;1822;2237;-415
13:00;37.5483675;55.7388362;692;577;115
13:00;37.5528619;55.6016929;348;369;-21
13:00;37.5547367;55.670291;2788;2644;144
13:00;37.5581576;55.7897125;2304;2159;145
13:00;37.5591032;55.7103574;280;391;-111
13:00;37.5615355;55.7645028;3257;3443;-186
13:00;37.5629779;55.6779484;2595;2838;-243
13:00;37.5637548;55.7233832;1370;1358;12
13:00;37.5660392;55.7444645;2092;2606;-514
13:00;37.5663098;55.7437756;3136;3277;-141
13:00;37.5736132;55.6878389;2765;2736;29
13:00;37.5740376;55.8347143;3424;2773;651
13:00;37.5756626;55.8182119;3151;2458;693
13:00;37.5768339;55.56931;2396;1974;422
13:00;37.5773899;55.7605891;1231;1307;-76
13:00;37.5794779;55.726854;2352;2632;-280
13:00;37.5798606;55.7609017;1727;1823;-96
13:00;37.5812016;55.8074277;1834;1906;-72
13:00;37.5822992;55.7473712;1983;2407;-424
13:00;37.5826348;55.7487722;528;598;-70
13:00;37.5837069;55.7766908;1495;1844;-349
13:00;37.5840306;55.7761643;2910;2973;-63
13:00;37.5859796;55.7077138;3082;3311;-229
13:00;37.5873192;55.8978497;2575;2247;328
13:00;37.5876906;55.7928665;3440;3529;-89
13:00;37.5898414;55.8472205;1298;971;327
13:00;37.5943769;55.7355873;2013;2242;-229
13:00;37.5943769;55.7355873;0;0;0
13:00;37.5957904;55.7701264;2522;2606;-84
13:00;37.5964216;55.582549;974;730;244
13:00;37.5981698;55.6529571;1575;1500;75
13:00;37.598314;55.6520286;544;520;24
13:00;37.6007529;55.7518731;456;472;-16
13:00;37.6009269;55.5951773;1349;1089;260
13:00;37.6020659;55.779514;2943;2933;10
13:00;37.6024384;55.8836915;1742;1548;194
13:00;37.6029929;55.7803918;1789;1768;21
13:00;37.6032245;55.7450091;2276;2695;-419
13:00;37.6041499;55.6124609;2736;2504;232
13:00;37.6048165;55.8634536;2578;2324;254
13:00;37.6056238;55.7653522;3433;4373;-940
13:00;37.6056692;55.6627149;1310;1282;28
13:00;37.6066657;55.7508858;346;471;-125
13:00;37.6067634;55.64069;1837;1613;224
13:00;37.6068123;55.7521318;1551;2039;-488
13:00;37.60792;55.7194704;1950;2150;-200
13:00;37.608832;55.7524514;919;1244;-325
13:00;37.6091534;55.7295817;1918;2001;-83
13:00;37.6091666;55.622278;1715;1539;176
13:00;37.6097183;55.7649696;1225;1440;-215
13:00;37.6103732;55.6722659;883;841;42
13:00;37.6118212;55.730075;1043;1175;-132
13:00;37.6150302;55.7813266;618;592;26
13:00;37.61611;55.7953478;1265;1352;-87
13:00;37.616177;55.7577183;3106;4195;-1089
13:00;37.6176267;55.7379525;1485;1521;-36
13:00;37.6187593;55.6533004;5121;4032;1089
13:00;37.6188598;55.7710979;1771;2096;-325
13:00;37.6202837;55.7685309;600;710;-110
13:00;37.621965;55.7566721;1180;1738;-558
13:00;37.6220906;55.7287137;1391;1448;-57
13:00;37.6227483;55.6830582;1776;1950;-174
13:00;37.6231936;55.7087682;2999;3203;-204
13:00;37.6248369;55.7274387;1743;1596;147
13:00;37.626016;55.7607712;1631;1762;-131
13:00;37.6270765;55.7408687;1960;2433;-473
13:00;37.6279157;55.7598754;1435;1658;-223
13:00;37.6290658;55.7417709;2253;2687;-434
13:00;37.6317458;55.7728672;1849;2006;-157
13:00;37.6323159;55.7812257;1986;1797;189
13:00;37.6331969;55.7797556;2271;2175;96
13:00;37.633222;55.7555058;3914;4668;-754
13:00;37.6361518;55.7933484;1222;1319;-97
13:00;37.6372552;55.76613;1362;1677;-315
13:00;37.6374183;55.7304321;2902;3240;-338
13:00;37.63768;55.7317782;2181;2320;-139
13:00;37.6383529;55.8453055;1320;1191;129
13:00;37.6387088;55.8086032;2664;2533;131
13:00;37.6389332;55.7659277;1502;1762;-260
13:00;37.6398306;55.7668232;389;536;-147
13:00;37.6411949;55.8211047;1705;1695;10
13:00;37.6484221;55.768931;2132;2134;-2
13:00;37.6491378;55.6549517;2608;1905;703
13:00;37.6506474;55.7416183;2225;2373;-148
13:00;37.6519536;55.740344;907;1073;-166
13:00;37.6526488;55.7413884;2316;2533;-217
13:00;37.6526672;55.8551422;1466;1381;85
13:00;37.6545092;55.7748736;1810;1763;47
13:00;37.656231;55.7754248;4100;3613;487
13:00;37.6565565;55.6358179;2756;2319;437
13:00;37.656572;55.7571067;2503;2488;15
13:00;37.6576183;55.7073699;2712;3011;-299
13:00;37.658076;55.7581501;2244;2518;-274
13:00;37.6591277;55.7572695;1473;1711;-238
13:00;37.6614511;55.8871576;2471;2017;454
13:00;37.6638965;55.6784809;3115;2768;347
13:00;37.6641638;55.8697248;2770;2241;529
13:00;37.6661457;55.7317659;2251;2560;-309
13:00;37.6667866;55.7330126;329;455;-126
13:00;37.6672754;55.7803946;1662;1839;-177
13:00;37.6693833;55.6215598;2805;2511;294
13:00;37.6756382;55.718932;1106;1174;-68
13:00;37.6801346;55.7889129;2357;2487;-130
13:00;37.6801957;55.7729753;4062;3850;212
13:00;37.6820384;55.7464709;1373;1465;-92
13:00;37.6822989;55.7457322;1226;1226;0
13:00;37.6850483;55.7075562;1430;1378;52
13:00;37.6867847;55.7253024;1487;1427;60
13:00;37.6947891;55.613247;1163;1063;100
13:00;37.7038734;55.7820537;2048;2210;-162
13:00;37.7157645;55.7961475;3023;2946;77
13:00;37.7193262;55.6109687;3993;2932;1061
13:00;37.7200209;55.7520069;2990;2855;135
13:00;37.7207673;55.7830875;2575;2414;161
13:00;37.7268243;55.6933636;1265;1093;172
13:00;37.7318594;55.7087389;3046;2793;253
13:00;37.7344362;55.8146017;1605;1192;413
13:00;37.7431944;55.6500225;2194;1924;270
13:00;37.7433398;55.6331579;582;571;11
13:00;37.743772;55.621144;517;475;42
13:00;37.7445335;55.6137894;1542;1380;162
13:00;37.7447684;55.8039662;917;716;201
13:00;37.7452899;55.61193;346;345;1
13:00;37.7498443;55.757225;1528;1382;146
13:00;37.7506502;55.6596899;2193;1970;223
13:00;37.750729;55.788524;1288;855;433
13:00;37.7532335;55.6907556;919;853;66
13:00;37.7619338;55.6756254;2681;2124;557
13:00;37.7657487;55.7055754;4245;3245;1000
13:00;37.7814948;55.787812;1504;1319;185
13:00;37.7864677;55.751266;2350;1966;384
13:00;37.7935753;55.7170907;2864;2513;351
13:00;37.7985144;55.8093419;3831;2921;910
13:00;37.7992368;55.7947324;2610;2013;597
13:00;37.8166274;55.7517187;4602;3187;1415
13:00;37.8179174;55.715631;7215;4951;2264
14:00;37.3622257;55.8458623;1437;1347;90
14:00;37.3824179;55.8356604;317;284;33
14:00;37.3855554;55.825092;211;169;42
14:00;37.4031859;55.8037346;1157;1117;40
14:00;37.4082585;55.7568353;1530;1457;73
14:00;37.4169177;55.7408429;2960;2286;674
14:00;37.4363874;55.860731;2370;2311;59
14:00;37.4366398;55.8264976;3297;2930;367
14:00;37.4397991;55.8503173;3128;2866;262
14:00;37.4459574;55.7308185;715;745;-30
14:00;37.4460094;55.7307016;1159;1068;91
14:00;37.4643097;55.8085823;3091;2769;322
14:00;37.4671944;55.7359279;379;416;-37
14:00;37.4707354;55.7296453;2192;1951;241
14:00;37.4761955;55.8548635;3976;3590;386
14:00;37.4832383;55.6636112;5332;4646;686
14:00;37.4834225;55.7394565;812;876;-64
14:00;37.4865846;55.8400444;2675;2435;240
14:00;37.4937378;55.7933364;3274;2985;289
14:00;37.4978443;55.7436954;1522;1636;-114
14:00;37.4978477;55.8190209;4616;4253;363
14:00;37.506415;55.6767308;2473;2364;109
14:00;37.5080944;55.6186964;3056;3012;44
14:00;37.5148913;55.8049784;3425;2764;661
14:00;37.5149237;55.7460754;1165;1408;-243
14:00;37.5177438;55.7362565;1108;872;236
14:00;37.5190729;55.6330883;2125;2011;114
14:00;37.5194078;55.7775074;3174;2973;201
14:00;37.5262001;55.6425059;2507;2455;52
14:00;37.5324136;55.8002374;3349;3136;213
14:00;37.5337173;55.6062069;1751;2108;-357
14:00;37.5340698;55.692163;3306;2799;507
14:00;37.53429;55.7400038;702;550;152
14:00;37.534383;55.7483228;267;306;-39
14:00;37.5401361;55.6567573;2722;2519;203
14:00;37.5413387;55.7500562;983;828;155
14:00;37.5464401;55.7735045;2244;2324;-80
14:00;37.5483675;55.7388362;615;775;-160
14:00;37.5528619;55.6016929;486;422;64
14:00;37.5547367;55.670291;2864;2798;66
14:00;37.5581576;55.7897125;2559;2146;413
14:00;37.5591032;55.7103574;336;342;-6
14:00;37.5615355;55.7645028;4026;3483;543
14:00;37.5629779;55.6779484;2910;2792;118
14:00;37.5637548;55.7233832;1722;1307;415
14:00;37.5660392;55.7444645;2418;2917;-499
14:00;37.5663098;55.7437756;3545;3532;13
14:00;37.5736132;55.6878389;3271;2879;392
14:00;37.5740376;55.8347143;3396;3164;232
14:00;37.5756626;55.8182119;3119;2666;453
14:00;37.5768339;55.56931;2371;2349;22
14:00;37.5773899;55.7605891;1419;1339;80
14:00;37.5794779;55.726854;2962;2558;404
14:00;37.5798606;55.7609017;1798;1810;-12
14:00;37.5812016;55.8074277;2135;1887;248
14:00;37.5822992;55.7473712;2384;2388;-4
14:00;37.5826348;55.7487722;688;552;136
14:00;37.5837069;55.7766908;1728;1890;-162
14:00;37.5840306;55.7761643;2923;2913;10
14:00;37.5859796;55.7077138;3328;3211;117
14:00;37.5873192;55.8978497;2399;2624;-225
14:00;37.5876906;55.7928665;3696;3400;296
14:00;37.5898414;55.8472205;1338;1204;134
14:00;37.5943769;55.7355873;2491;2145;346
14:00;37.5943769;55.7355873;0;0;0
14:00;37.5957904;55.7701264;2788;2848;-60
14:00;37.5964216;55.582549;889;801;88
14:00;37.5981698;55.6529571;1759;1639;120
14:00;37.598314;55.6520286;535;592;-57
14:00;37.6007529;55.7518731;535;476;59
14:00;37.6009269;55.5951773;1289;1343;-54
14:00;37.6020659;55.779514;3245;2756;489
14:00;37.6024384;55.8836915;1691;1766;-75
14:00;37.6029929;55.7803918;2023;1651;372
14:00;37.6032245;55.7450091;2766;2855;-89
14:00;37.6041499;55.6124609;2701;2790;-89
14:00;37.6048165;55.8634536;2554;2850;-296
14:00;37.6056238;55.7653522;3995;4217;-222
14:00;37.6056692;55.6627149;1577;1286;291
14:00;37.6066657;55.7508858;495;419;76
14:00;37.6067634;55.64069;1736;1992;-256
14:00;37.6068123;55.7521318;1981;2089;-108
14:00;37.60792;55.7194704;2325;1876;449
14:00;37.608832;55.7524514;1156;1221;-65
14:00;37.6091534;55.7295817;2280;1809;471
14:00;37.6091666;55.622278;1692;1783;-91
14:00;37.6097183;55.7649696;1433;1458;-25
14:00;37.6103732;55.6722659;927;878;49
14:00;37.6118212;55.730075;1029;1070;-41
14:00;37.6150302;55.7813266;717;662;55
14:00;37.61611;55.7953478;1412;1287;125
14:00;37.616177;55.7577183;3856;4430;-574
14:00;37.6176267;55.7379525;1521;1618;-97
14:00;37.6187593;55.6533004;5145;4048;1097
14:00;37.6188598;55.7710979;2113;1863;250
14:00;37.6202837;55.7685309;691;738;-47
14:00;37.621965;55.7566721;1646;1899;-253
14:00;37.6220906;55.7287137;1611;1380;231
14:00;37.6227483;55.6830582;2337;2072;265
14:00;37.6231936;55.7087682;3478;3553;-75
14:00;37.6248369;55.7274387;1764;1496;268
14:00;37.626016;55.7607712;1804;1697;107
14:00;37.6270765;55.7408687;2387;2585;-198
14:00;37.6279157;55.7598754;1698;1674;24
14:00;37.6290658;55.7417709;2547;2493;54
14:00;37.6317458;55.7728672;2060;2047;13
14:00;37.6323159;55.7812257;2073;1740;333
14:00;37.6331969;55.7797556;2490;2157;333
14:00;37.633222;55.7555058;4354;4203;151
14:00;37.6361518;55.7933484;1389;1291;98
14:00;37.6372552;55.76613;1656;1530;126
14:00;37.6374183;55.7304321;3385;3171;214
14:00;37.63768;55.7317782;2664;2398;266
14:00;37.6383529;55.8453055;1411;1311;100
14:00;37.6387088;55.8086032;2719;2457;262
14:00;37.6389332;55.7659277;1500;1667;-167
14:00;37.6398306;55.7668232;482;440;42
14:00;37.6411949;55.8211047;1981;1830;151
14:00;37.6484221;55.768931;2289;2162;127
14:00;37.6491378;55.6549517;2992;1877;1115
14:00;37.6506474;55.7416183;2540;2324;216
14:00;37.6519536;55.740344;1251;1080;171
14:00;37.6526488;55.7413884;2499;2517;-18
14:00;37.6526672;55.8551422;1497;1629;-132
14:00;37.6545092;55.7748736;2462;2023;439
14:00;37.656231;55.7754248;3495;4053;-558
14:00;37.6565565;55.6358179;2679;2677;2
14:00;37.656572;55.7571067;2610;2711;-101
14:00;37.6576183;55.7073699;3291;3093;198
14:00;37.658076;55.7581501;3214;2503;711
14:00;37.6591277;55.7572695;1690;1834;-144
14:00;37.6614511;55.8871576;2417;2391;26
14:00;37.6638965;55.6784809;3476;3130;346
14:00;37.6641638;55.8697248;2844;2589;255
14:00;37.6661457;55.7317659;2635;2470;165
14:00;37.6667866;55.7330126;415;417;-2
14:00;37.6672754;55.7803946;1818;1904;-86
14:00;37.6693833;55.6215598;2814;3046;-232
14:00;37.6756382;55.718932;1286;1085;201
14:00;37.6801346;55.7889129;2880;2452;428
14:00;37.6801957;55.7729753;4769;3628;1141
14:00;37.6820384;55.7464709;1630;1678;-48
14:00;37.6822989;55.7457322;1338;1338;0
14:00;37.6850483;55.7075562;1738;1329;409
14:00;37.6867847;55.7253024;1774;1422;352
14:00;37.6947891;55.613247;1234;1230;4
14:00;37.7038734;55.7820537;2394;2144;250
14:00;37.7157645;55.7961475;3157;2836;321
14:00;37.7193262;55.6109687;3949;3259;690
14:00;37.7200209;55.7520069;3387;2779;608
14:00;37.7207673;55.7830875;2757;2438;319
14:00;37.7268243;55.6933636;1324;1211;113
14:00;37.7318594;55.7087389;3112;3109;3
14:00;37.7344362;55.8146017;1749;1363;386
14:00;37.7431944;55.6500225;2130;2541;-411
14:00;37.7433398;55.6331579;536;681;-145
14:00;37.743772;55.621144;539;603;-64
14:00;37.7445335;55.6137894;1519;1581;-62
14:00;37.7447684;55.8039662;899;810;89
14:00;37.7452899;55.61193;311;380;-69
14:00;37.7498443;55.757225;1787;1469;318
14:00;37.7506502;55.6596899;2212;2428;-216
14:00;37.750729;55.788524;1210;895;315
14:00;37.7532335;55.6907556;1058;966;92
14:00;37.7619338;55.6756254;2800;2361;439
14:00;37.7657487;55.7055754;4000;3864;136
14:00;37.7814948;55.787812;1569;1314;255
14:00;37.7864677;55.751266;2372;2290;82
14:00;37.7935753;55.7170907;2673;2429;244
14:00;37.7985144;55.8093419;3529;3452;77
14:00;37.7992368;55.7947324;2705;2221;484
14:00;37.8166274;55.7517187;3963;4183;-220
14:00;37.8179174;55.715631;5864;5834;30
15:00;37.3622257;55.8458623;1279;1632;-353
15:00;37.3824179;55.8356604;348;335;13
15:00;37.3855554;55.825092;251;130;121
15:00;37.4031859;55.8037346;1244;1329;-85
15:00;37.4082585;55.7568353;1459;1611;-152
15:00;37.4169177;55.7408429;3066;2546;520
15:00;37.4363874;55.860731;2335;2910;-575
15:00;37.4366398;55.8264976;3570;3313;257
15:00;37.4397991;55.8503173;3069;3471;-402
15:00;37.4459574;55.7308185;773;774;-1
15:00;37.4460094;55.7307016;1178;1213;-35
15:00;37.4643097;55.8085823;3365;3082;283
15:00;37.4671944;55.7359279;388;456;-68
15:00;37.4707354;55.7296453;2227;2141;86
15:00;37.4761955;55.8548635;3818;4479;-661
15:00;37.4832383;55.6636112;5212;5179;33
15:00;37.4834225;55.7394565;1047;1019;28
15:00;37.4865846;55.8400444;2987;2544;443
15:00;37.4937378;55.7933364;3400;3137;263
15:00;37.4978443;55.7436954;1634;1654;-20
15:00;37.4978477;55.8190209;4862;4414;448
15:00;37.506415;55.6767308;2652;2515;137
15:00;37.5080944;55.6186964;2865;3218;-353
15:00;37.5148913;55.8049784;3627;2956;671
15:00;37.5149237;55.7460754;1682;1548;134
15:00;37.5177438;55.7362565;1061;891;170
15:00;37.5190729;55.6330883;2191;2062;129
15:00;37.5194078;55.7775074;3513;3120;393
15:00;37.5262001;55.6425059;2514;2736;-222
15:00;37.5324136;55.8002374;3789;3148;641
15:00;37.5337173;55.6062069;1667;2539;-872
15:00;37.5340698;55.692163;3377;2865;512
15:00;37.53429;55.7400038;725;518;207
15:00;37.534383;55.7483228;340;262;78
15:00;37.5401361;55.6567573;2938;2526;412
15:00;37.5413387;55.7500562;1172;785;387
15:00;37.5464401;55.7735045;3350;2349;1001
15:00;37.5483675;55.7388362;582;730;-148
15:00;37.5528619;55.6016929;459;511;-52
15:00;37.5547367;55.670291;3015;2927;88
15:00;37.5581576;55.7897125;2787;2152;635
15:00;37.5591032;55.7103574;457;397;60
15:00;37.5615355;55.7645028;4169;3405;764
15:00;37.5629779;55.6779484;3276;2714;562
15:00;37.5637548;55.7233832;2112;1373;739
15:00;37.5660392;55.7444645;3387;3140;247
15:00;37.5663098;55.7437756;3973;3586;387
15:00;37.5736132;55.6878389;3418;2889;529
15:00;37.5740376;55.8347143;3492;3612;-120
15:00;37.5756626;55.8182119;2968;2900;68
15:00;37.5768339;55.56931;2125;2877;-752
15:00;37.5773899;55.7605891;1595;1257;338
15:00;37.5794779;55.726854;3198;2292;906
15:00;37.5798606;55.7609017;2046;1570;476
15:00;37.5812016;55.8074277;2434;1894;540
15:00;37.5822992;55.7473712;2788;2206;582
15:00;37.5826348;55.7487722;680;547;133
15:00;37.5837069;55.7766908;2135;1860;275
15:00;37.5840306;55.7761643;3589;3044;545
15:00;37.5859796;55.7077138;4028;3015;1013
15:00;37.5873192;55.8978497;2282;3116;-834
15:00;37.5876906;55.7928665;3957;3567;390
15:00;37.5898414;55.8472205;1371;1172;199
15:00;37.5943769;55.7355873;2680;1810;870
15:00;37.5943769;55.7355873;0;0;0
15:00;37.5957904;55.7701264;3114;2544;570
15:00;37.5964216;55.582549;971;897;74
15:00;37.5981698;55.6529571;1743;1748;-5
15:00;37.598314;55.6520286;532;618;-86
15:00;37.6007529;55.7518731;604;426;178
15:00;37.6009269;55.5951773;1245;1558;-313
15:00;37.6020659;55.779514;3581;2523;1058
15:00;37.6024384;55.8836915;1603;2022;-419
15:00;37.6029929;55.7803918;2271;1608;663
15:00;37.6032245;55.7450091;3001;2208;793
15:00;37.6041499;55.6124609;2666;3216;-550
15:00;37.6048165;55.8634536;2573;3297;-724
15:00;37.6056238;55.7653522;4611;4293;318
15:00;37.6056692;55.6627149;1751;1447;304
15:00;37.6066657;55.7508858;553;415;138
15:00;37.6067634;55.64069;2030;2204;-174
15:00;37.6068123;55.7521318;2277;2046;231
15:00;37.60792;55.7194704;2701;1998;703
15:00;37.608832;55.7524514;1448;1075;373
15:00;37.6091534;55.7295817;2580;1516;1064
15:00;37.6091666;55.622278;1814;1950;-136
15:00;37.6097183;55.7649696;1616;1382;234
15:00;37.6103732;55.6722659;1021;801;220
15:00;37.6118212;55.730075;1260;1050;210
15:00;37.6150302;55.7813266;895;703;192
15:00;37.61611;55.7953478;1528;1322;206
15:00;37.616177;55.7577183;4457;4434;23
15:00;37.6176267;55.7379525;1749;1465;284
15:00;37.6187593;55.6533004;5133;4209;924
15:00;37.6188598;55.7710979;2220;1826;394
15:00;37.6202837;55.7685309;723;675;48
15:00;37.621965;55.7566721;1850;1760;90
15:00;37.6220906;55.7287137;1750;1293;457
15:00;37.6227483;55.6830582;2203;2184;19
15:00;37.6231936;55.7087682;4053;3308;745
15:00;37.6248369;55.7274387;2179;1334;845
15:00;37.626016;55.7607712;2061;1598;463
15:00;37.6270765;55.7408687;2825;2500;325
15:00;37.6279157;55.7598754;1880;1595;285
15:00;37.6290658;55.7417709;2935;2358;577
15:00;37.6317458;55.7728672;2260;1841;419
15:00;37.6323159;55.7812257;2235;1681;554
15:00;37.6331969;55.7797556;2668;1945;723
15:00;37.633222;55.7555058;5336;3944;1392
15:00;37.6361518;55.7933484;1584;1247;337
15:00;37.6372552;55.76613;1674;1430;244
15:00;37.6374183;55.7304321;3765;2945;820
15:00;37.63768;55.7317782;2660;2261;399
15:00;37.6383529;55.8453055;1625;1399;226
15:00;37.6387088;55.8086032;3551;2396;1155
15:00;37.6389332;55.7659277;1811;1737;74
15:00;37.6398306;55.7668232;541;471;70
15:00;37.6411949;55.8211047;2066;1938;128
15:00;37.6484221;55.768931;2577;2030;547
15:00;37.6491378;55.6549517;3284;1997;1287
15:00;37.6506474;55.7416183;2662;2289;373
15:00;37.6519536;55.740344;1158;976;182
15:00;37.6526488;55.7413884;2826;2514;312
15:00;37.6526672;55.8551422;1525;1888;-363
15:00;37.6545092;55.7748736;2457;2094;363
15:00;37.656231;55.7754248;3508;5634;-2126
15:00;37.6565565;55.6358179;2524;3089;-565
15:00;37.656572;55.7571067;2900;2946;-46
15:00;37.6576183;55.7073699;3768;3285;483
15:00;37.658076;55.7581501;2604;2833;-229
15:00;37.6591277;55.7572695;1768;1729;39
15:00;37.6614511;55.8871576;2419;2969;-550
15:00;37.6638965;55.6784809;3606;3739;-133
15:00;37.6641638;55.8697248;2668;3150;-482
15:00;37.6661457;55.7317659;2910;2636;274
15:00;37.6667866;55.7330126;471;390;81
15:00;37.6672754;55.7803946;2362;1749;613
15:00;37.6693833;55.6215598;3000;3449;-449
15:00;37.6756382;55.718932;1551;1089;462
15:00;37.6801346;55.7889129;3340;2537;803
15:00;37.6801957;55.7729753;5173;3316;1857
15:00;37.6820384;55.7464709;1920;1744;176
15:00;37.6822989;55.7457322;1474;1365;109
15:00;37.6850483;55.7075562;1935;1355;580
15:00;37.6867847;55.7253024;2126;1197;929
15:00;37.6947891;55.613247;1373;1494;-121
15:00;37.7038734;55.7820537;2672;2186;486
15:00;37.7157645;55.7961475;3412;3096;316
15:00;37.7193262;55.6109687;3682;3834;-152
15:00;37.7200209;55.7520069;4060;2829;1231
15:00;37.7207673;55.7830875;3459;2603;856
15:00;37.7268243;55.6933636;1118;1514;-396
15:00;37.7318594;55.7087389;3474;3318;156
15:00;37.7344362;55.8146017;2035;1577;458
15:00;37.7431944;55.6500225;2160;3034;-874
15:00;37.7433398;55.6331579;513;978;-465
15:00;37.743772;55.621144;524;719;-195
15:00;37.7445335;55.6137894;1591;2062;-471
15:00;37.7447684;55.8039662;1006;929;77
15:00;37.7452899;55.61193;313;449;-136
15:00;37.7498443;55.757225;2188;1549;639
15:00;37.7506502;55.6596899;2165;2791;-626
15:00;37.750729;55.788524;1139;946;193
15:00;37.7532335;55.6907556;1121;1171;-50
15:00;37.7619338;55.6756254;3004;2735;269
15:00;37.7657487;55.7055754;3809;4672;-863
15:00;37.7814948;55.787812;1338;1511;-173
15:00;37.7864677;55.751266;2446;2798;-352
15:00;37.7935753;55.7170907;2790;2798;-8
15:00;37.7985144;55.8093419;3544;4244;-700
15:00;37.7992368;55.7947324;2599;2664;-65
15:00;37.8166274;55.7517187;3749;5548;-1799
15:00;37.8179174;55.715631;5764;7468;-1704
16:00;37.3622257;55.8458623;1288;1974;-686
16:00;37.3824179;55.8356604;364;443;-79
16:00;37.3855554;55.825092;301;118;183
16:00;37.4031859;55.8037346;1385;1618;-233
16:00;37.4082585;55.7568353;1633;1856;-223
16:00;37.4169177;55.7408429;3617;2786;831
16:00;37.4363874;55.860731;2416;3840;-1424
16:00;37.4366398;55.8264976;4753;4041;712
16:00;37.4397991;55.8503173;3370;4173;-803
16:00;37.4459574;55.7308185;887;847;40
16:00;37.4460094;55.7307016;1553;1412;141
16:00;37.4643097;55.8085823;3735;3470;265
16:00;37.4671944;55.7359279;387;497;-110
16:00;37.4707354;55.7296453;2641;2470;171
16:00;37.4761955;55.8548635;3807;5230;-1423
16:00;37.4832383;55.6636112;6088;5832;256
16:00;37.4834225;55.7394565;1140;1153;-13
16:00;37.4865846;55.8400444;3240;2977;263
16:00;37.4937378;55.7933364;4041;3564;477
16:00;37.4978443;55.7436954;2092;1613;479
16:00;37.4978477;55.8190209;5858;5092;766
16:00;37.506415;55.6767308;2828;2830;-2
16:00;37.5080944;55.6186964;3371;4191;-820
16:00;37.5148913;55.8049784;4453;2954;1499
16:00;37.5149237;55.7460754;2323;1722;601
16:00;37.5177438;55.7362565;1341;906;435
16:00;37.5190729;55.6330883;2126;2594;-468
16:00;37.5194078;55.7775074;4570;3092;1478
16:00;37.5262001;55.6425059;2685;3223;-538
16:00;37.5324136;55.8002374;4670;2795;1875
16:00;37.5337173;55.6062069;2049;3133;-1084
16:00;37.5340698;55.692163;4022;3102;920
16:00;37.53429;55.7400038;900;530;370
16:00;37.534383;55.7483228;420;203;217
16:00;37.5401361;55.6567573;4192;2696;1496
16:00;37.5413387;55.7500562;1460;696;764
16:00;37.5464401;55.7735045;3493;2727;766
16:00;37.5483675;55.7388362;644;705;-61
16:00;37.5528619;55.6016929;403;672;-269
16:00;37.5547367;55.670291;3224;3118;106
16:00;37.5581576;55.7897125;3663;2206;1457
16:00;37.5591032;55.7103574;636;433;203
16:00;37.5615355;55.7645028;5440;3176;2264
16:00;37.5629779;55.6779484;3583;2888;695
16:00;37.5637548;55.7233832;2104;1534;570
16:00;37.5660392;55.7444645;3089;3731;-642
16:00;37.5663098;55.7437756;4560;3664;896
16:00;37.5736132;55.6878389;4105;3123;982
16:00;37.5740376;55.8347143;3995;4491;-496
16:00;37.5756626;55.8182119;3309;3503;-194
16:00;37.5768339;55.56931;2250;3940;-1690
16:00;37.5773899;55.7605891;1964;1186;778
16:00;37.5794779;55.726854;3363;2087;1276
16:00;37.5798606;55.7609017;2326;1873;453
16:00;37.5812016;55.8074277;3036;1972;1064
16:00;37.5822992;55.7473712;3130;2008;1122
16:00;37.5826348;55.7487722;722;498;224
16:00;37.5837069;55.7766908;2491;1882;609
16:00;37.5840306;55.7761643;4408;2920;1488
16:00;37.5859796;55.7077138;4940;2933;2007
16:00;37.5873192;55.8978497;2484;4255;-1771
16:00;37.5876906;55.7928665;4820;3728;1092
16:00;37.5898414;55.8472205;1675;1377;298
16:00;37.5943769;55.7355873;2844;1639;1205
16:00;37.5943769;55.7355873;0;0;0
16:00;37.5957904;55.7701264;3385;2729;656
16:00;37.5964216;55.582549;1181;1063;118
16:00;37.5981698;55.6529571;2166;2177;-11
16:00;37.598314;55.6520286;613;750;-137
16:00;37.6007529;55.7518731;555;410;145
16:00;37.6009269;55.5951773;1379;2060;-681
16:00;37.6020659;55.779514;4344;2422;1922
16:00;37.6024384;55.8836915;1766;2738;-972
16:00;37.6029929;55.7803918;2971;1561;1410
16:00;37.6032245;55.7450091;3273;2119;1154
16:00;37.6041499;55.6124609;3017;3772;-755
16:00;37.6048165;55.8634536;3000;4384;-1384
16:00;37.6056238;55.7653522;5179;4074;1105
16:00;37.6056692;55.6627149;1654;1642;12
16:00;37.6066657;55.7508858;685;340;345
16:00;37.6067634;55.64069;2220;2854;-634
16:00;37.6068123;55.7521318;2397;1747;650
16:00;37.60792;55.7194704;3178;1990;1188
16:00;37.608832;55.7524514;1627;971;656
16:00;37.6091534;55.7295817;2731;1464;1267
16:00;37.6091666;55.622278;2235;2172;63
16:00;37.6097183;55.7649696;1828;1338;490
16:00;37.6103732;55.6722659;1321;954;367
16:00;37.6118212;55.730075;1589;990;599
16:00;37.6150302;55.7813266;1040;672;368
16:00;37.61611;55.7953478;1971;1302;669
16:00;37.616177;55.7577183;5296;4549;747
16:00;37.6176267;55.7379525;2051;1327;724
16:00;37.6187593;55.6533004;5647;4694;953
16:00;37.6188598;55.7710979;2565;1698;867
16:00;37.6202837;55.7685309;1007;638;369
16:00;37.621965;55.7566721;2426;1678;748
16:00;37.6220906;55.7287137;2029;1140;889
16:00;37.6227483;55.6830582;3237;2444;793
16:00;37.6231936;55.7087682;4764;2991;1773
16:00;37.6248369;55.7274387;2244;1226;1018
16:00;37.626016;55.7607712;2410;1605;805
16:00;37.6270765;55.7408687;3186;2320;866
16:00;37.6279157;55.7598754;2148;1375;773
16:00;37.6290658;55.7417709;3571;2203;1368
16:00;37.6317458;55.7728672;2622;1838;784
16:00;37.6323159;55.7812257;2408;1571;837
16:00;37.6331969;55.7797556;3029;1874;1155
16:00;37.633222;55.7555058;6068;3824;2244
16:00;37.6361518;55.7933484;1740;1398;342
16:00;37.6372552;55.76613;2019;1390;629
16:00;37.6374183;55.7304321;4208;2763;1445
16:00;37.63768;55.7317782;3235;2301;934
16:00;37.6383529;55.8453055;2162;1480;682
16:00;37.6387088;55.8086032;4262;2431;1831
16:00;37.6389332;55.7659277;2086;1667;419
16:00;37.6398306;55.7668232;691;482;209
16:00;37.6411949;55.8211047;2522;2180;342
16:00;37.6484221;55.768931;3021;1874;1147
16:00;37.6491378;55.6549517;3608;2268;1340
16:00;37.6506474;55.7416183;3186;2162;1024
16:00;37.6519536;55.740344;1488;972;516
16:00;37.6526488;55.7413884;3122;2311;811
16:00;37.6526672;55.8551422;1869;2286;-417
16:00;37.6545092;55.7748736;2419;2316;103
16:00;37.656231;55.7754248;3969;7590;-3621
16:00;37.6565565;55.6358179;2900;3959;-1059
16:00;37.656572;55.7571067;3121;3505;-384
16:00;37.6576183;55.7073699;5326;3233;2093
16:00;37.658076;55.7581501;3167;3383;-216
16:00;37.6591277;55.7572695;2042;1765;277
16:00;37.6614511;55.8871576;2642;4063;-1421
16:00;37.6638965;55.6784809;4227;4367;-140
16:00;37.6641638;55.8697248;2844;4108;-1264
16:00;37.6661457;55.7317659;3461;2611;850
16:00;37.6667866;55.7330126;524;420;104
16:00;37.6672754;55.7803946;2709;1694;1015
16:00;37.6693833;55.6215598;3170;4439;-1269
16:00;37.6756382;55.718932;2064;957;1107
16:00;37.6801346;55.7889129;3606;2611;995
16:00;37.6801957;55.7729753;6040;3293;2747
16:00;37.6820384;55.7464709;2105;2345;-240
16:00;37.6822989;55.7457322;1736;1578;158
16:00;37.6850483;55.7075562;2748;1444;1304
16:00;37.6867847;55.7253024;2704;1114;1590
16:00;37.6947891;55.613247;1173;1962;-789
16:00;37.7038734;55.7820537;3449;2337;1112
16:00;37.7157645;55.7961475;3872;3202;670
16:00;37.7193262;55.6109687;3788;4896;-1108
16:00;37.7200209;55.7520069;5738;3059;2679
16:00;37.7207673;55.7830875;5038;2563;2475
16:00;37.7268243;55.6933636;1477;2002;-525
16:00;37.7318594;55.7087389;4385;3871;514
16:00;37.7344362;55.8146017;2217;1949;268
16:00;37.7431944;55.6500225;2131;4065;-1934
16:00;37.7433398;55.6331579;549;1286;-737
16:00;37.743772;55.621144;469;930;-461
16:00;37.7445335;55.6137894;1505;2774;-1269
16:00;37.7447684;55.8039662;1306;1081;225
16:00;37.7452899;55.61193;314;748;-434
16:00;37.7498443;55.757225;2948;1483;1465
16:00;37.7506502;55.6596899;2363;3615;-1252
16:00;37.750729;55.788524;1417;1197;220
16:00;37.7532335;55.6907556;1129;1503;-374
16:00;37.7619338;55.6756254;3522;3536;-14
16:00;37.7657487;55.7055754;3696;5991;-2295
16:00;37.7814948;55.787812;1675;1636;39
16:00;37.7864677;55.751266;2536;3196;-660
16:00;37.7935753;55.7170907;2979;3502;-523
16:00;37.7985144;55.8093419;3870;5496;-1626
16:00;37.7992368;55.7947324;2517;3318;-801
16:00;37.8166274;55.7517187;3820;7569;-3749
16:00;37.8179174;55.715631;5832;9945;-4113
17:00;37.3622257;55.8458623;1433;3137;-1704
17:00;37.3824179;55.8356604;451;659;-208
17:00;37.3855554;55.825092;448;154;294
17:00;37.4031859;55.8037346;2052;2511;-459
17:00;37.4082585;55.7568353;2017;2548;-531
17:00;37.4169177;55.7408429;4161;4039;122
17:00;37.4363874;55.860731;2929;5397;-2468
17:00;37.4366398;55.8264976;5029;5649;-620
17:00;37.4397991;55.8503173;3998;6020;-2022
17:00;37.4459574;55.7308185;1013;1085;-72
17:00;37.4460094;55.7307016;2298;2388;-90
17:00;37.4643097;55.8085823;5039;4717;322
17:00;37.4671944;55.7359279;429;607;-178
17:00;37.4707354;55.7296453;3783;3454;329
17:00;37.4761955;55.8548635;4714;7955;-3241
17:00;37.4832383;55.6636112;8087;8420;-333
17:00;37.4834225;55.7394565;1257;1387;-130
17:00;37.4865846;55.8400444;4621;4034;587
17:00;37.4937378;55.7933364;5783;4961;822
17:00;37.4978443;55.7436954;2516;1755;761
17:00;37.4978477;55.8190209;7986;6487;1499
17:00;37.506415;55.6767308;4236;3801;435
17:00;37.5080944;55.6186964;4077;5436;-1359
17:00;37.5148913;55.8049784;5914;3380;2534
17:00;37.5149237;55.7460754;2557;2467;90
17:00;37.5177438;55.7362565;1975;1150;825
17:00;37.5190729;55.6330883;2398;3284;-886
17:00;37.5194078;55.7775074;6895;4063;2832
17:00;37.5262001;55.6425059;3242;4039;-797
17:00;37.5324136;55.8002374;6968;3454;3514
17:00;37.5337173;55.6062069;2418;4505;-2087
17:00;37.5340698;55.692163;5148;3635;1513
17:00;37.53429;55.7400038;1224;616;608
17:00;37.534383;55.7483228;819;194;625
17:00;37.5401361;55.6567573;6753;3082;3671
17:00;37.5413387;55.7500562;2595;703;1892
17:00;37.5464401;55.7735045;5624;3879;1745
17:00;37.5483675;55.7388362;926;882;44
17:00;37.5528619;55.6016929;365;989;-624
17:00;37.5547367;55.670291;4384;4005;379
17:00;37.5581576;55.7897125;5367;2625;2742
17:00;37.5591032;55.7103574;986;422;564
17:00;37.5615355;55.7645028;7702;3647;4055
17:00;37.5629779;55.6779484;4733;3385;1348
17:00;37.5637548;55.7233832;3050;1566;1484
17:00;37.5660392;55.7444645;5511;5471;40
17:00;37.5663098;55.7437756;6574;4351;2223
17:00;37.5736132;55.6878389;4830;3708;1122
17:00;37.5740376;55.8347143;4953;6632;-1679
17:00;37.5756626;55.8182119;4471;5287;-816
17:00;37.5768339;55.56931;2577;6171;-3594
17:00;37.5773899;55.7605891;2899;1323;1576
17:00;37.5794779;55.726854;4391;2163;2228
17:00;37.5798606;55.7609017;3336;1743;1593
17:00;37.5812016;55.8074277;4768;2544;2224
17:00;37.5822992;55.7473712;5120;2167;2953
17:00;37.5826348;55.7487722;1006;525;481
17:00;37.5837069;55.7766908;3847;2706;1141
17:00;37.5840306;55.7761643;5946;3492;2454
17:00;37.5859796;55.7077138;7083;2960;4123
17:00;37.5873192;55.8978497;2824;7059;-4235
17:00;37.5876906;55.7928665;7403;4498;2905
17:00;37.5898414;55.8472205;2568;1738;830
17:00;37.5943769;55.7355873;3861;1702;2159
17:00;37.5943769;55.7355873;0;0;0
17:00;37.5957904;55.7701264;5009;2884;2125
17:00;37.5964216;55.582549;1638;1464;174
17:00;37.5981698;55.6529571;2679;2775;-96
17:00;37.598314;55.6520286;802;977;-175
17:00;37.6007529;55.7518731;893;395;498
17:00;37.6009269;55.5951773;1654;3223;-1569
17:00;37.6020659;55.779514;5441;2457;2984
17:00;37.6024384;55.8836915;2061;4185;-2124
17:00;37.6029929;55.7803918;3546;1620;1926
17:00;37.6032245;55.7450091;4721;2056;2665
17:00;37.6041499;55.6124609;3830;5477;-1647
17:00;37.6048165;55.8634536;3642;6647;-3005
17:00;37.6056238;55.7653522;7228;4473;2755
17:00;37.6056692;55.6627149;2430;2113;317
17:00;37.6066657;55.7508858;925;326;599
17:00;37.6067634;55.64069;2761;4084;-1323
17:00;37.6068123;55.7521318;3534;2017;1517
17:00;37.60792;55.7194704;4437;2180;2257
17:00;37.608832;55.7524514;2395;1043;1352
17:00;37.6091534;55.7295817;3584;1444;2140
17:00;37.6091666;55.622278;3209;3106;103
17:00;37.6097183;55.7649696;2878;1407;1471
17:00;37.6103732;55.6722659;1986;1205;781
17:00;37.6118212;55.730075;2143;1029;1114
17:00;37.6150302;55.7813266;1777;843;934
17:00;37.61611;55.7953478;3225;1737;1488
17:00;37.616177;55.7577183;7012;4840;2172
17:00;37.6176267;55.7379525;3053;1251;1802
17:00;37.6187593;55.6533004;7643;6064;1579
17:00;37.6188598;55.7710979;3760;1659;2101
17:00;37.6202837;55.7685309;1664;669;995
17:00;37.621965;55.7566721;3770;1868;1902
17:00;37.6220906;55.7287137;2477;1359;1118
17:00;37.6227483;55.6830582;5305;3046;2259
17:00;37.6231936;55.7087682;6761;3154;3607
17:00;37.6248369;55.7274387;3353;1413;1940
17:00;37.626016;55.7607712;3497;1435;2062
17:00;37.6270765;55.7408687;4967;2432;2535
17:00;37.6279157;55.7598754;3395;1297;2098
17:00;37.6290658;55.7417709;5533;2200;3333
17:00;37.6317458;55.7728672;3359;1976;1383
17:00;37.6323159;55.7812257;3368;1636;1732
17:00;37.6331969;55.7797556;4150;1985;2165
17:00;37.633222;55.7555058;9401;3760;5641
17:00;37.6361518;55.7933484;2483;1689;794
17:00;37.6372552;55.76613;3260;1481;1779
17:00;37.6374183;55.7304321;6757;3247;3510
17:00;37.63768;55.7317782;4905;2958;1947
17:00;37.6383529;55.8453055;2835;1989;846
17:00;37.6387088;55.8086032;6342;2721;3621
17:00;37.6389332;55.7659277;2889;1733;1156
17:00;37.6398306;55.7668232;1266;492;774
17:00;37.6411949;55.8211047;3394;2864;530
17:00;37.6484221;55.768931;5016;1936;3080
17:00;37.6491378;55.6549517;4492;2637;1855
17:00;37.6506474;55.7416183;4294;2706;1588
17:00;37.6519536;55.740344;1915;1118;797
17:00;37.6526488;55.7413884;4218;2522;1696
17:00;37.6526672;55.8551422;2614;3146;-532
17:00;37.6545092;55.7748736;2963;3377;-414
17:00;37.656231;55.7754248;4812;14906;-10094
17:00;37.6565565;55.6358179;3582;5658;-2076
17:00;37.656572;55.7571067;4452;5406;-954
17:00;37.6576183;55.7073699;7053;3694;3359
17:00;37.658076;55.7581501;4324;5417;-1093
17:00;37.6591277;55.7572695;2593;1881;712
17:00;37.6614511;55.8871576;2854;6715;-3861
17:00;37.6638965;55.6784809;5356;6232;-876
17:00;37.6641638;55.8697248;2895;6212;-3317
17:00;37.6661457;55.7317659;5330;3295;2035
17:00;37.6667866;55.7330126;1162;505;657
17:00;37.6672754;55.7803946;4111;1949;2162
17:00;37.6693833;55.6215598;4163;6968;-2805
17:00;37.6756382;55.718932;3235;978;2257
17:00;37.6801346;55.7889129;4551;2726;1825
17:00;37.6801957;55.7729753;9232;3533;5699
17:00;37.6820384;55.7464709;3287;3267;20
17:00;37.6822989;55.7457322;2978;2023;955
17:00;37.6850483;55.7075562;4365;1697;2668
17:00;37.6867847;55.7253024;4456;950;3506
17:00;37.6947891;55.613247;1314;2974;-1660
17:00;37.7038734;55.7820537;5866;2885;2981
17:00;37.7157645;55.7961475;5643;4239;1404
17:00;37.7193262;55.6109687;4879;7195;-2316
17:00;37.7200209;55.7520069;9098;3873;5225
17:00;37.7207673;55.7830875;6761;3108;3653
17:00;37.7268243;55.6933636;1714;2999;-1285
17:00;37.7318594;55.7087389;5875;5677;198
17:00;37.7344362;55.8146017;2712;2841;-129
17:00;37.7431944;55.6500225;2568;6901;-4333
17:00;37.7433398;55.6331579;598;2199;-1601
17:00;37.743772;55.621144;556;1571;-1015
17:00;37.7445335;55.6137894;1591;4488;-2897
17:00;37.7447684;55.8039662;1947;1518;429
17:00;37.7452899;55.61193;417;1183;-766
17:00;37.7498443;55.757225;4970;1839;3131
17:00;37.7506502;55.6596899;2704;5443;-2739
17:00;37.750729;55.788524;1918;1460;458
17:00;37.7532335;55.6907556;1383;2198;-815
17:00;37.7619338;55.6756254;3450;5601;-2151
17:00;37.7657487;55.7055754;4803;9743;-4940
17:00;37.7814948;55.787812;1847;2321;-474
17:00;37.7864677;55.751266;3353;5227;-1874
17:00;37.7935753;55.7170907;3807;4962;-1155
17:00;37.7985144;55.8093419;4564;8780;-4216
17:00;37.7992368;55.7947324;3056;4955;-1899
17:00;37.8166274;55.7517187;4241;13656;-9415
17:00;37.8179174;55.715631;7154;16890;-9736
18:00;37.3622257;55.8458623;1478;5563;-4085
18:00;37.3824179;55.8356604;483;1039;-556
18:00;37.3855554;55.825092;1049;131;918
18:00;37.4031859;55.8037346;2360;4025;-1665
18:00;37.4082585;55.7568353;2647;3842;-1195
18:00;37.4169177;55.7408429;4627;6308;-1681
18:00;37.4363874;55.860731;3046;8794;-5748
18:00;37.4366398;55.8264976;5520;9170;-3650
18:00;37.4397991;55.8503173;4287;9248;-4961
18:00;37.4459574;55.7308185;1071;1466;-395
18:00;37.4460094;55.7307016;2707;3953;-1246
18:00;37.4643097;55.8085823;5369;6710;-1341
18:00;37.4671944;55.7359279;496;800;-304
18:00;37.4707354;55.7296453;5037;5881;-844
18:00;37.4761955;55.8548635;5357;12686;-7329
18:00;37.4832383;55.6636112;9103;12867;-3764
18:00;37.4834225;55.7394565;1421;1795;-374
18:00;37.4865846;55.8400444;5793;6173;-380
18:00;37.4937378;55.7933364;7252;7761;-509
18:00;37.4978443;55.7436954;2601;2293;308
18:00;37.4978477;55.8190209;10386;9910;476
18:00;37.506415;55.6767308;5643;5950;-307
18:00;37.5080944;55.6186964;4804;8373;-3569
18:00;37.5148913;55.8049784;7933;4645;3288
18:00;37.5149237;55.7460754;3141;3609;-468
18:00;37.5177438;55.7362565;2907;1476;1431
18:00;37.5190729;55.6330883;2693;5302;-2609
18:00;37.5194078;55.7775074;8586;5703;2883
18:00;37.5262001;55.6425059;3705;6194;-2489
18:00;37.5324136;55.8002374;8391;4961;3430
18:00;37.5337173;55.6062069;2374;6956;-4582
18:00;37.5340698;55.692163;6118;5277;841
18:00;37.53429;55.7400038;1429;826;603
18:00;37.534383;55.7483228;2018;187;1831
18:00;37.5401361;55.6567573;9299;4615;4684
18:00;37.5413387;55.7500562;5475;922;4553
18:00;37.5464401;55.7735045;8185;5491;2694
18:00;37.5483675;55.7388362;934;1095;-161
18:00;37.5528619;55.6016929;400;1494;-1094
18:00;37.5547367;55.670291;6732;6052;680
18:00;37.5581576;55.7897125;7339;3709;3630
18:00;37.5591032;55.7103574;1451;462;989
18:00;37.5615355;55.7645028;11784;4607;7177
18:00;37.5629779;55.6779484;5976;4595;1381
18:00;37.5637548;55.7233832;3715;1662;2053
18:00;37.5660392;55.7444645;7823;8965;-1142
18:00;37.5663098;55.7437756;7751;6315;1436
18:00;37.5736132;55.6878389;6569;5739;830
18:00;37.5740376;55.8347143;5113;9941;-4828
18:00;37.5756626;55.8182119;5274;8424;-3150
18:00;37.5768339;55.56931;2650;9694;-7044
18:00;37.5773899;55.7605891;4441;1835;2606
18:00;37.5794779;55.726854;5543;2781;2762
18:00;37.5798606;55.7609017;5339;2054;3285
18:00;37.5812016;55.8074277;8318;3771;4547
18:00;37.5822992;55.7473712;7277;2922;4355
18:00;37.5826348;55.7487722;1438;721;717
18:00;37.5837069;55.7766908;5569;3962;1607
18:00;37.5840306;55.7761643;9840;4762;5078
18:00;37.5859796;55.7077138;10056;3804;6252
18:00;37.5873192;55.8978497;3249;11603;-8354
18:00;37.5876906;55.7928665;10897;6508;4389
18:00;37.5898414;55.8472205;3474;2556;918
18:00;37.5943769;55.7355873;6327;2082;4245
18:00;37.5943769;55.7355873;0;0;0
18:00;37.5957904;55.7701264;7906;4874;3032
18:00;37.5964216;55.582549;2000;2621;-621
18:00;37.5981698;55.6529571;3218;4094;-876
18:00;37.598314;55.6520286;1065;1590;-525
18:00;37.6007529;55.7518731;1288;567;721
18:00;37.6009269;55.5951773;1582;5301;-3719
18:00;37.6020659;55.779514;7338;3191;4147
18:00;37.6024384;55.8836915;2345;6422;-4077
18:00;37.6029929;55.7803918;5003;2101;2902
18:00;37.6032245;55.7450091;6528;2316;4212
18:00;37.6041499;55.6124609;4418;7992;-3574
18:00;37.6048165;55.8634536;3894;11076;-7182
18:00;37.6056238;55.7653522;10929;6629;4300
18:00;37.6056692;55.6627149;2479;3107;-628
18:00;37.6066657;55.7508858;1850;451;1399
18:00;37.6067634;55.64069;2967;6017;-3050
18:00;37.6068123;55.7521318;5767;2809;2958
18:00;37.60792;55.7194704;6434;2887;3547
18:00;37.608832;55.7524514;3405;1222;2183
18:00;37.6091534;55.7295817;4713;1757;2956
18:00;37.6091666;55.622278;4257;4901;-644
18:00;37.6097183;55.7649696;4885;1975;2910
18:00;37.6103732;55.6722659;2454;1910;544
18:00;37.6118212;55.730075;3933;1145;2788
18:00;37.6150302;55.7813266;2962;1104;1858
18:00;37.61611;55.7953478;5197;2762;2435
18:00;37.616177;55.7577183;10406;7100;3306
18:00;37.6176267;55.7379525;5172;1527;3645
18:00;37.6187593;55.6533004;9761;8405;1356
18:00;37.6188598;55.7710979;5821;1929;3892
18:00;37.6202837;55.7685309;3304;804;2500
18:00;37.621965;55.7566721;6315;2261;4054
18:00;37.6220906;55.7287137;4168;1727;2441
18:00;37.6227483;55.6830582;8316;4114;4202
18:00;37.6231936;55.7087682;10398;3966;6432
18:00;37.6248369;55.7274387;5567;2026;3541
18:00;37.626016;55.7607712;6375;1909;4466
18:00;37.6270765;55.7408687;8857;2742;6115
18:00;37.6279157;55.7598754;5115;1688;3427
18:00;37.6290658;55.7417709;7182;2801;4381
18:00;37.6317458;55.7728672;4939;2239;2700
18:00;37.6323159;55.7812257;4763;1998;2765
18:00;37.6331969;55.7797556;6401;2393;4008
18:00;37.633222;55.7555058;14917;4673;10244
18:00;37.6361518;55.7933484;3391;2487;904
18:00;37.6372552;55.76613;6654;1798;4856
18:00;37.6374183;55.7304321;12004;4365;7639
18:00;37.63768;55.7317782;8857;3918;4939
18:00;37.6383529;55.8453055;3664;2806;858
18:00;37.6387088;55.8086032;7760;3912;3848
18:00;37.6389332;55.7659277;4242;2099;2143
18:00;37.6398306;55.7668232;3084;633;2451
18:00;37.6411949;55.8211047;4263;4060;203
18:00;37.6484221;55.768931;8210;2136;6074
18:00;37.6491378;55.6549517;4891;3086;1805
18:00;37.6506474;55.7416183;7131;3521;3610
18:00;37.6519536;55.740344;3316;1539;1777
18:00;37.6526488;55.7413884;6607;3318;3289
18:00;37.6526672;55.8551422;2709;5206;-2497
18:00;37.6545092;55.7748736;4835;6419;-1584
18:00;37.656231;55.7754248;5104;24785;-19681
18:00;37.6565565;55.6358179;4250;8474;-4224
18:00;37.656572;55.7571067;6611;8991;-2380
18:00;37.6576183;55.7073699;9006;4246;4760
18:00;37.658076;55.7581501;6061;9250;-3189
18:00;37.6591277;55.7572695;4146;2652;1494
18:00;37.6614511;55.8871576;2863;11043;-8180
18:00;37.6638965;55.6784809;6581;9263;-2682
18:00;37.6641638;55.8697248;3289;11078;-7789
18:00;37.6661457;55.7317659;7719;4184;3535
18:00;37.6667866;55.7330126;2333;699;1634
18:00;37.6672754;55.7803946;5371;2578;2793
18:00;37.6693833;55.6215598;3741;10706;-6965
18:00;37.6756382;55.718932;3752;1154;2598
18:00;37.6801346;55.7889129;6404;3942;2462
18:00;37.6801957;55.7729753;10863;4120;6743
18:00;37.6820384;55.7464709;4597;5109;-512
18:00;37.6822989;55.7457322;4423;3050;1373
18:00;37.6850483;55.7075562;6672;2047;4625
18:00;37.6867847;55.7253024;5731;969;4762
18:00;37.6947891;55.613247;1399;4487;-3088
18:00;37.7038734;55.7820537;7894;4312;3582
18:00;37.7157645;55.7961475;7739;6415;1324
18:00;37.7193262;55.6109687;4630;10683;-6053
18:00;37.7200209;55.7520069;10215;5725;4490
18:00;37.7207673;55.7830875;7665;3937;3728
18:00;37.7268243;55.6933636;1704;4669;-2965
18:00;37.7318594;55.7087389;6939;8236;-1297
18:00;37.7344362;55.8146017;2759;4858;-2099
18:00;37.7431944;55.6500225;2629;10542;-7913
18:00;37.7433398;55.6331579;559;3559;-3000
18:00;37.743772;55.621144;543;2544;-2001
18:00;37.7445335;55.6137894;1316;6388;-5072
18:00;37.7447684;55.8039662;1899;2392;-493
18:00;37.7452899;55.61193;425;1886;-1461
18:00;37.7498443;55.757225;5620;2413;3207
18:00;37.7506502;55.6596899;2863;9184;-6321
18:00;37.750729;55.788524;2550;1967;583
18:00;37.7532335;55.6907556;1521;3158;-1637
18:00;37.7619338;55.6756254;2784;8901;-6117
18:00;37.7657487;55.7055754;5522;14966;-9444
18:00;37.7814948;55.787812;1771;3455;-1684
18:00;37.7864677;55.751266;3945;9078;-5133
18:00;37.7935753;55.7170907;4518;7829;-3311
18:00;37.7985144;55.8093419;4351;14539;-10188
18:00;37.7992368;55.7947324;3554;7533;-3979
18:00;37.8166274;55.7517187;3971;22247;-18276
18:00;37.8179174;55.715631;6145;27892;-21747
19:00;37.3622257;55.8458623;1244;5948;-4704
19:00;37.3824179;55.8356604;382;948;-566
19:00;37.3855554;55.825092;473;133;340
19:00;37.4031859;55.8037346;1563;3861;-2298
19:00;37.4082585;55.7568353;2251;3300;-1049
19:00;37.4169177;55.7408429;3302;5358;-2056
19:00;37.4363874;55.860731;2233;7650;-5417
19:00;37.4366398;55.8264976;3192;7291;-4099
19:00;37.4397991;55.8503173;2698;8528;-5830
19:00;37.4459574;55.7308185;670;933;-263
19:00;37.4460094;55.7307016;1545;3102;-1557
19:00;37.4643097;55.8085823;3779;5153;-1374
19:00;37.4671944;55.7359279;323;704;-381
19:00;37.4707354;55.7296453;3192;4657;-1465
19:00;37.4761955;55.8548635;3695;10475;-6780
19:00;37.4832383;55.6636112;5489;10483;-4994
19:00;37.4834225;55.7394565;998;1317;-319
19:00;37.4865846;55.8400444;3483;4819;-1336
19:00;37.4937378;55.7933364;4766;5620;-854
19:00;37.4978443;55.7436954;2054;1607;447
19:00;37.4978477;55.8190209;6686;7684;-998
19:00;37.506415;55.6767308;2908;5055;-2147
19:00;37.5080944;55.6186964;3193;6581;-3388
19:00;37.5148913;55.8049784;4985;3476;1509
19:00;37.5149237;55.7460754;1720;2483;-763
19:00;37.5177438;55.7362565;1815;1104;711
19:00;37.5190729;55.6330883;2187;4601;-2414
19:00;37.5194078;55.7775074;5102;4480;622
19:00;37.5262001;55.6425059;2615;5361;-2746
19:00;37.5324136;55.8002374;5602;3515;2087
19:00;37.5337173;55.6062069;1406;6468;-5062
19:00;37.5340698;55.692163;4378;3968;410
19:00;37.53429;55.7400038;865;506;359
19:00;37.534383;55.7483228;1059;116;943
19:00;37.5401361;55.6567573;4909;3324;1585
19:00;37.5413387;55.7500562;2958;728;2230
19:00;37.5464401;55.7735045;4459;3438;1021
19:00;37.5483675;55.7388362;621;754;-133
19:00;37.5528619;55.6016929;323;1286;-963
19:00;37.5547367;55.670291;4046;4540;-494
19:00;37.5581576;55.7897125;4480;2636;1844
19:00;37.5591032;55.7103574;844;337;507
19:00;37.5615355;55.7645028;7357;3183;4174
19:00;37.5629779;55.6779484;4056;3472;584
19:00;37.5637548;55.7233832;2386;1144;1242
19:00;37.5660392;55.7444645;4305;5266;-961
19:00;37.5663098;55.7437756;6086;4370;1716
19:00;37.5736132;55.6878389;4071;4288;-217
19:00;37.5740376;55.8347143;3664;7231;-3567
19:00;37.5756626;55.8182119;3482;5907;-2425
19:00;37.5768339;55.56931;2064;8256;-6192
19:00;37.5773899;55.7605891;2497;1317;1180
19:00;37.5794779;55.726854;3728;1632;2096
19:00;37.5798606;55.7609017;3077;1189;1888
19:00;37.5812016;55.8074277;4294;2681;1613
19:00;37.5822992;55.7473712;4475;1435;3040
19:00;37.5826348;55.7487722;906;384;522
19:00;37.5837069;55.7766908;3375;2469;906
19:00;37.5840306;55.7761643;6069;3094;2975
19:00;37.5859796;55.7077138;6927;2462;4465
19:00;37.5873192;55.8978497;2426;8988;-6562
19:00;37.5876906;55.7928665;7273;3987;3286
19:00;37.5898414;55.8472205;1745;2027;-282
19:00;37.5943769;55.7355873;4358;1206;3152
19:00;37.5943769;55.7355873;0;0;0
19:00;37.5957904;55.7701264;5151;1892;3259
19:00;37.5964216;55.582549;1245;1916;-671
19:00;37.5981698;55.6529571;2004;3363;-1359
19:00;37.598314;55.6520286;699;1182;-483
19:00;37.6007529;55.7518731;663;306;357
19:00;37.6009269;55.5951773;1070;4406;-3336
19:00;37.6020659;55.779514;4747;1870;2877
19:00;37.6024384;55.8836915;1664;5243;-3579
19:00;37.6029929;55.7803918;3190;1375;1815
19:00;37.6032245;55.7450091;4386;1112;3274
19:00;37.6041499;55.6124609;3324;6083;-2759
19:00;37.6048165;55.8634536;2612;8590;-5978
19:00;37.6056238;55.7653522;7487;3431;4056
19:00;37.6056692;55.6627149;1861;2425;-564
19:00;37.6066657;55.7508858;1058;214;844
19:00;37.6067634;55.64069;2083;4914;-2831
19:00;37.6068123;55.7521318;3574;1367;2207
19:00;37.60792;55.7194704;4145;1967;2178
19:00;37.608832;55.7524514;2075;563;1512
19:00;37.6091534;55.7295817;2990;1089;1901
19:00;37.6091666;55.622278;2584;3820;-1236
19:00;37.6097183;55.7649696;2924;1081;1843
19:00;37.6103732;55.6722659;1275;1436;-161
19:00;37.6118212;55.730075;2132;740;1392
19:00;37.6150302;55.7813266;1333;591;742
19:00;37.61611;55.7953478;3068;1717;1351
19:00;37.616177;55.7577183;7174;3011;4163
19:00;37.6176267;55.7379525;3206;865;2341
19:00;37.6187593;55.6533004;5620;6685;-1065
19:00;37.6188598;55.7710979;3274;1240;2034
19:00;37.6202837;55.7685309;1654;486;1168
19:00;37.621965;55.7566721;3897;1270;2627
19:00;37.6220906;55.7287137;2395;866;1529
19:00;37.6227483;55.6830582;4026;2711;1315
19:00;37.6231936;55.7087682;6372;2716;3656
19:00;37.6248369;55.7274387;3073;973;2100
19:00;37.626016;55.7607712;3241;933;2308
19:00;37.6270765;55.7408687;5136;1597;3539
19:00;37.6279157;55.7598754;2679;922;1757
19:00;37.6290658;55.7417709;4780;1750;3030
19:00;37.6317458;55.7728672;3132;1516;1616
19:00;37.6323159;55.7812257;2732;1348;1384
19:00;37.6331969;55.7797556;3443;1539;1904
19:00;37.633222;55.7555058;8377;2689;5688
19:00;37.6361518;55.7933484;2173;1444;729
19:00;37.6372552;55.76613;3218;994;2224
19:00;37.6374183;55.7304321;7415;2243;5172
19:00;37.63768;55.7317782;5782;2553;3229
19:00;37.6383529;55.8453055;1827;2170;-343
19:00;37.6387088;55.8086032;4805;2802;2003
19:00;37.6389332;55.7659277;2709;1338;1371
19:00;37.6398306;55.7668232;1332;333;999
19:00;37.6411949;55.8211047;2444;2983;-539
19:00;37.6484221;55.768931;4142;1283;2859
19:00;37.6491378;55.6549517;2797;2419;378
19:00;37.6506474;55.7416183;4094;1561;2533
19:00;37.6519536;55.740344;1820;846;974
19:00;37.6526488;55.7413884;4374;2022;2352
19:00;37.6526672;55.8551422;1738;4318;-2580
19:00;37.6545092;55.7748736;2977;3623;-646
19:00;37.656231;55.7754248;3356;14834;-11478
19:00;37.6565565;55.6358179;2570;7052;-4482
19:00;37.656572;55.7571067;4412;5173;-761
19:00;37.6576183;55.7073699;5959;2844;3115
19:00;37.658076;55.7581501;3763;5189;-1426
19:00;37.6591277;55.7572695;3110;1652;1458
19:00;37.6614511;55.8871576;1858;9183;-7325
19:00;37.6638965;55.6784809;4187;7163;-2976
19:00;37.6641638;55.8697248;2274;9146;-6872
19:00;37.6661457;55.7317659;4674;2907;1767
19:00;37.6667866;55.7330126;1151;424;727
19:00;37.6672754;55.7803946;3143;1698;1445
19:00;37.6693833;55.6215598;2592;7745;-5153
19:00;37.6756382;55.718932;2064;729;1335
19:00;37.6801346;55.7889129;3956;2758;1198
19:00;37.6801957;55.7729753;7765;2559;5206
19:00;37.6820384;55.7464709;2512;3369;-857
19:00;37.6822989;55.7457322;2513;1902;611
19:00;37.6850483;55.7075562;2921;1693;1228
19:00;37.6867847;55.7253024;2967;628;2339
19:00;37.6947891;55.613247;848;3874;-3026
19:00;37.7038734;55.7820537;4140;2819;1321
19:00;37.7157645;55.7961475;3967;5017;-1050
19:00;37.7193262;55.6109687;3546;9206;-5660
19:00;37.7200209;55.7520069;5206;3667;1539
19:00;37.7207673;55.7830875;4638;2741;1897
19:00;37.7268243;55.6933636;1133;3505;-2372
19:00;37.7318594;55.7087389;3947;6068;-2121
19:00;37.7344362;55.8146017;1574;4123;-2549
19:00;37.7431944;55.6500225;2101;8773;-6672
19:00;37.7433398;55.6331579;389;3121;-2732
19:00;37.743772;55.621144;396;2386;-1990
19:00;37.7445335;55.6137894;1090;5499;-4409
19:00;37.7447684;55.8039662;1179;1884;-705
19:00;37.7452899;55.61193;344;1669;-1325
19:00;37.7498443;55.757225;2474;1900;574
19:00;37.7506502;55.6596899;2291;8157;-5866
19:00;37.750729;55.788524;1379;1489;-110
19:00;37.7532335;55.6907556;1081;2603;-1522
19:00;37.7619338;55.6756254;1864;7518;-5654
19:00;37.7657487;55.7055754;3820;11558;-7738
19:00;37.7814948;55.787812;1148;2870;-1722
19:00;37.7864677;55.751266;2167;7234;-5067
19:00;37.7935753;55.7170907;2599;6370;-3771
19:00;37.7985144;55.8093419;2935;12371;-9436
19:00;37.7992368;55.7947324;2229;6380;-4151
19:00;37.8166274;55.7517187;2699;16899;-14200
19:00;37.8179174;55.715631;4407;22476;-18069
20:00;37.3622257;55.8458623;964;3404;-2440
20:00;37.3824179;55.8356604;268;643;-375
20:00;37.3855554;55.825092;291;98;193
20:00;37.4031859;55.8037346;1092;2462;-1370
20:00;37.4082585;55.7568353;1426;2224;-798
20:00;37.4169177;55.7408429;2018;3528;-1510
20:00;37.4363874;55.860731;1639;5088;-3449
20:00;37.4366398;55.8264976;2203;4779;-2576
20:00;37.4397991;55.8503173;1782;5344;-3562
20:00;37.4459574;55.7308185;435;654;-219
20:00;37.4460094;55.7307016;1020;2028;-1008
20:00;37.4643097;55.8085823;2850;3463;-613
20:00;37.4671944;55.7359279;250;476;-226
20:00;37.4707354;55.7296453;1949;3269;-1320
20:00;37.4761955;55.8548635;2646;7028;-4382
20:00;37.4832383;55.6636112;3816;7067;-3251
20:00;37.4834225;55.7394565;715;894;-179
20:00;37.4865846;55.8400444;2057;3148;-1091
20:00;37.4937378;55.7933364;3066;3743;-677
20:00;37.4978443;55.7436954;1381;911;470
20:00;37.4978477;55.8190209;4532;4923;-391
20:00;37.506415;55.6767308;2068;3321;-1253
20:00;37.5080944;55.6186964;2447;4223;-1776
20:00;37.5148913;55.8049784;3130;2175;955
20:00;37.5149237;55.7460754;1291;1651;-360
20:00;37.5177438;55.7362565;978;675;303
20:00;37.5190729;55.6330883;1412;2949;-1537
20:00;37.5194078;55.7775074;3604;3048;556
20:00;37.5262001;55.6425059;1917;3632;-1715
20:00;37.5324136;55.8002374;3635;2166;1469
20:00;37.5337173;55.6062069;1049;4113;-3064
20:00;37.5340698;55.692163;3618;2480;1138
20:00;37.53429;55.7400038;552;324;228
20:00;37.534383;55.7483228;564;96;468
20:00;37.5401361;55.6567573;2927;2306;621
20:00;37.5413387;55.7500562;1708;406;1302
20:00;37.5464401;55.7735045;2465;2267;198
20:00;37.5483675;55.7388362;442;543;-101
20:00;37.5528619;55.6016929;151;850;-699
20:00;37.5547367;55.670291;2969;2970;-1
20:00;37.5581576;55.7897125;2804;1843;961
20:00;37.5591032;55.7103574;561;179;382
20:00;37.5615355;55.7645028;4630;2025;2605
20:00;37.5629779;55.6779484;3031;2352;679
20:00;37.5637548;55.7233832;1427;764;663
20:00;37.5660392;55.7444645;3042;3118;-76
20:00;37.5663098;55.7437756;4556;2679;1877
20:00;37.5736132;55.6878389;2791;2919;-128
20:00;37.5740376;55.8347143;2506;5083;-2577
20:00;37.5756626;55.8182119;2277;3774;-1497
20:00;37.5768339;55.56931;1636;5357;-3721
20:00;37.5773899;55.7605891;1716;726;990
20:00;37.5794779;55.726854;2494;897;1597
20:00;37.5798606;55.7609017;1961;686;1275
20:00;37.5812016;55.8074277;2394;1671;723
20:00;37.5822992;55.7473712;3364;949;2415
20:00;37.5826348;55.7487722;565;301;264
20:00;37.5837069;55.7766908;1982;1491;491
20:00;37.5840306;55.7761643;4216;1855;2361
20:00;37.5859796;55.7077138;4485;1661;2824
20:00;37.5873192;55.8978497;1686;5803;-4117
20:00;37.5876906;55.7928665;4583;2315;2268
20:00;37.5898414;55.8472205;977;1389;-412
20:00;37.5943769;55.7355873;2769;665;2104
20:00;37.5943769;55.7355873;0;0;0
20:00;37.5957904;55.7701264;3426;937;2489
20:00;37.5964216;55.582549;747;1307;-560
20:00;37.5981698;55.6529571;1373;2338;-965
20:00;37.598314;55.6520286;595;772;-177
20:00;37.6007529;55.7518731;481;142;339
20:00;37.6009269;55.5951773;913;2947;-2034
20:00;37.6020659;55.779514;3186;916;2270
20:00;37.6024384;55.8836915;1281;3302;-2021
20:00;37.6029929;55.7803918;2131;699;1432
20:00;37.6032245;55.7450091;2790;630;2160
20:00;37.6041499;55.6124609;2505;3846;-1341
20:00;37.6048165;55.8634536;2198;5482;-3284
20:00;37.6056238;55.7653522;5656;1641;4015
20:00;37.6056692;55.6627149;1134;1674;-540
20:00;37.6066657;55.7508858;528;102;426
20:00;37.6067634;55.64069;1582;3256;-1674
20:00;37.6068123;55.7521318;2739;728;2011
20:00;37.60792;55.7194704;2407;1205;1202
20:00;37.608832;55.7524514;1331;253;1078
20:00;37.6091534;55.7295817;1981;603;1378
20:00;37.6091666;55.622278;1691;2491;-800
20:00;37.6097183;55.7649696;1911;476;1435
20:00;37.6103732;55.6722659;809;1005;-196
20:00;37.6118212;55.730075;1310;431;879
20:00;37.6150302;55.7813266;1004;333;671
20:00;37.61611;55.7953478;1912;1032;880
20:00;37.616177;55.7577183;5690;1434;4256
20:00;37.6176267;55.7379525;1886;461;1425
20:00;37.6187593;55.6533004;3808;4764;-956
20:00;37.6188598;55.7710979;2129;690;1439
20:00;37.6202837;55.7685309;1016;243;773
20:00;37.621965;55.7566721;2730;606;2124
20:00;37.6220906;55.7287137;1662;538;1124
20:00;37.6227483;55.6830582;2077;1745;332
20:00;37.6231936;55.7087682;3884;1593;2291
20:00;37.6248369;55.7274387;1614;594;1020
20:00;37.626016;55.7607712;2491;406;2085
20:00;37.6270765;55.7408687;3312;802;2510
20:00;37.6279157;55.7598754;1852;459;1393
20:00;37.6290658;55.7417709;3117;876;2241
20:00;37.6317458;55.7728672;2020;733;1287
20:00;37.6323159;55.7812257;1824;662;1162
20:00;37.6331969;55.7797556;2262;831;1431
20:00;37.633222;55.7555058;5667;1212;4455
20:00;37.6361518;55.7933484;1500;906;594
20:00;37.6372552;55.76613;1976;544;1432
20:00;37.6374183;55.7304321;4217;1385;2832
20:00;37.63768;55.7317782;3207;1501;1706
20:00;37.6383529;55.8453055;1091;1442;-351
20:00;37.6387088;55.8086032;2740;1774;966
20:00;37.6389332;55.7659277;1957;729;1228
20:00;37.6398306;55.7668232;842;162;680
20:00;37.6411949;55.8211047;1751;1870;-119
20:00;37.6484221;55.768931;2324;701;1623
20:00;37.6491378;55.6549517;1901;1490;411
20:00;37.6506474;55.7416183;2837;881;1956
20:00;37.6519536;55.740344;1252;517;735
20:00;37.6526488;55.7413884;2918;1013;1905
20:00;37.6526672;55.8551422;1204;2788;-1584
20:00;37.6545092;55.7748736;1838;2206;-368
20:00;37.656231;55.7754248;2238;8784;-6546
20:00;37.6565565;55.6358179;1779;4901;-3122
20:00;37.656572;55.7571067;3089;2940;149
20:00;37.6576183;55.7073699;3887;1778;2109
20:00;37.658076;55.7581501;2544;2982;-438
20:00;37.6591277;55.7572695;2223;870;1353
20:00;37.6614511;55.8871576;1324;5743;-4419
20:00;37.6638965;55.6784809;2886;4693;-1807
20:00;37.6641638;55.8697248;1646;5655;-4009
20:00;37.6661457;55.7317659;2932;1851;1081
20:00;37.6667866;55.7330126;637;248;389
20:00;37.6672754;55.7803946;1973;1014;959
20:00;37.6693833;55.6215598;1588;5454;-3866
20:00;37.6756382;55.718932;1053;517;536
20:00;37.6801346;55.7889129;2474;1666;808
20:00;37.6801957;55.7729753;4410;1688;2722
20:00;37.6820384;55.7464709;1898;2038;-140
20:00;37.6822989;55.7457322;1614;1210;404
20:00;37.6850483;55.7075562;1872;980;892
20:00;37.6867847;55.7253024;1857;336;1521
20:00;37.6947891;55.613247;612;2459;-1847
20:00;37.7038734;55.7820537;2234;1687;547
20:00;37.7157645;55.7961475;2238;3505;-1267
20:00;37.7193262;55.6109687;2923;5990;-3067
20:00;37.7200209;55.7520069;3311;2265;1046
20:00;37.7207673;55.7830875;2853;1744;1109
20:00;37.7268243;55.6933636;860;2397;-1537
20:00;37.7318594;55.7087389;2494;4066;-1572
20:00;37.7344362;55.8146017;1081;2698;-1617
20:00;37.7431944;55.6500225;1657;5396;-3739
20:00;37.7433398;55.6331579;299;1930;-1631
20:00;37.743772;55.621144;344;1511;-1167
20:00;37.7445335;55.6137894;761;3590;-2829
20:00;37.7447684;55.8039662;712;1145;-433
20:00;37.7452899;55.61193;295;1030;-735
20:00;37.7498443;55.757225;1467;1270;197
20:00;37.7506502;55.6596899;1788;4948;-3160
20:00;37.750729;55.788524;1060;1060;0
20:00;37.7532335;55.6907556;588;1753;-1165
20:00;37.7619338;55.6756254;1371;4840;-3469
20:00;37.7657487;55.7055754;2768;8096;-5328
20:00;37.7814948;55.787812;900;1940;-1040
20:00;37.7864677;55.751266;1541;4787;-3246
20:00;37.7935753;55.7170907;1883;4150;-2267
20:00;37.7985144;55.8093419;2130;8345;-6215
20:00;37.7992368;55.7947324;1471;4042;-2571
20:00;37.8166274;55.7517187;2026;10838;-8812
20:00;37.8179174;55.715631;2770;15015;-12245
21:00;37.3622257;55.8458623;714;2361;-1647
21:00;37.3824179;55.8356604;155;401;-246
21:00;37.3855554;55.825092;191;70;121
21:00;37.4031859;55.8037346;746;1671;-925
21:00;37.4082585;55.7568353;1006;1462;-456
21:00;37.4169177;55.7408429;1332;2518;-1186
21:00;37.4363874;55.860731;1064;3298;-2234
21:00;37.4366398;55.8264976;1278;3180;-1902
21:00;37.4397991;55.8503173;1230;3825;-2595
21:00;37.4459574;55.7308185;302;465;-163
21:00;37.4460094;55.7307016;566;1534;-968
21:00;37.4643097;55.8085823;1993;2267;-274
21:00;37.4671944;55.7359279;135;304;-169
21:00;37.4707354;55.7296453;1379;2359;-980
21:00;37.4761955;55.8548635;1959;4791;-2832
21:00;37.4832383;55.6636112;2771;4633;-1862
21:00;37.4834225;55.7394565;672;608;64
21:00;37.4865846;55.8400444;1099;2199;-1100
21:00;37.4937378;55.7933364;2017;2614;-597
21:00;37.4978443;55.7436954;1168;592;576
21:00;37.4978477;55.8190209;3238;3203;35
21:00;37.506415;55.6767308;1495;2301;-806
21:00;37.5080944;55.6186964;1706;2737;-1031
21:00;37.5148913;55.8049784;1961;1641;320
21:00;37.5149237;55.7460754;841;1089;-248
21:00;37.5177438;55.7362565;596;458;138
21:00;37.5190729;55.6330883;920;2007;-1087
21:00;37.5194078;55.7775074;1894;2128;-234
21:00;37.5262001;55.6425059;1330;2473;-1143
21:00;37.5324136;55.8002374;2385;1584;801
21:00;37.5337173;55.6062069;709;2866;-2157
21:00;37.5340698;55.692163;2738;1824;914
21:00;37.53429;55.7400038;382;201;181
21:00;37.534383;55.7483228;228;86;142
21:00;37.5401361;55.6567573;1793;1524;269
21:00;37.5413387;55.7500562;1135;269;866
21:00;37.5464401;55.7735045;1391;1535;-144
21:00;37.5483675;55.7388362;283;455;-172
21:00;37.5528619;55.6016929;100;566;-466
21:00;37.5547367;55.670291;2182;2033;149
21:00;37.5581576;55.7897125;1532;1252;280
21:00;37.5591032;55.7103574;408;80;328
21:00;37.5615355;55.7645028;2822;1296;1526
21:00;37.5629779;55.6779484;1733;1641;92
21:00;37.5637548;55.7233832;757;535;222
21:00;37.5660392;55.7444645;1826;1952;-126
21:00;37.5663098;55.7437756;3535;1681;1854
21:00;37.5736132;55.6878389;1769;2095;-326
21:00;37.5740376;55.8347143;1730;3564;-1834
21:00;37.5756626;55.8182119;1309;2631;-1322
21:00;37.5768339;55.56931;1048;3548;-2500
21:00;37.5773899;55.7605891;1141;480;661
21:00;37.5794779;55.726854;1562;696;866
21:00;37.5798606;55.7609017;1908;348;1560
21:00;37.5812016;55.8074277;1370;1058;312
21:00;37.5822992;55.7473712;2621;503;2118
21:00;37.5826348;55.7487722;409;169;240
21:00;37.5837069;55.7766908;1407;1049;358
21:00;37.5840306;55.7761643;3072;1238;1834
21:00;37.5859796;55.7077138;3044;993;2051
21:00;37.5873192;55.8978497;1201;3700;-2499
21:00;37.5876906;55.7928665;2151;1495;656
21:00;37.5898414;55.8472205;670;956;-286
21:00;37.5943769;55.7355873;1790;421;1369
21:00;37.5943769;55.7355873;0;0;0
21:00;37.5957904;55.7701264;4179;599;3580
21:00;37.5964216;55.582549;417;821;-404
21:00;37.5981698;55.6529571;874;1698;-824
21:00;37.598314;55.6520286;301;543;-242
21:00;37.6007529;55.7518731;423;78;345
21:00;37.6009269;55.5951773;616;2068;-1452
21:00;37.6020659;55.779514;2342;622;1720
21:00;37.6024384;55.8836915;847;2082;-1235
21:00;37.6029929;55.7803918;1224;424;800
21:00;37.6032245;55.7450091;1798;336;1462
21:00;37.6041499;55.6124609;1446;2664;-1218
21:00;37.6048165;55.8634536;1609;3694;-2085
21:00;37.6056238;55.7653522;5158;946;4212
21:00;37.6056692;55.6627149;637;1147;-510
21:00;37.6066657;55.7508858;413;61;352
21:00;37.6067634;55.64069;1220;2161;-941
21:00;37.6068123;55.7521318;2449;392;2057
21:00;37.60792;55.7194704;1459;822;637
21:00;37.608832;55.7524514;1228;147;1081
21:00;37.6091534;55.7295817;1371;364;1007
21:00;37.6091666;55.622278;1253;1619;-366
21:00;37.6097183;55.7649696;1821;295;1526
21:00;37.6103732;55.6722659;583;724;-141
21:00;37.6118212;55.730075;859;260;599
21:00;37.6150302;55.7813266;482;234;248
21:00;37.61611;55.7953478;1076;777;299
21:00;37.616177;55.7577183;6369;649;5720
21:00;37.6176267;55.7379525;1069;254;815
21:00;37.6187593;55.6533004;2676;3466;-790
21:00;37.6188598;55.7710979;1442;359;1083
21:00;37.6202837;55.7685309;743;151;592
21:00;37.621965;55.7566721;2225;365;1860
21:00;37.6220906;55.7287137;1268;297;971
21:00;37.6227483;55.6830582;1255;928;327
21:00;37.6231936;55.7087682;2661;955;1706
21:00;37.6248369;55.7274387;1114;389;725
21:00;37.626016;55.7607712;1600;198;1402
21:00;37.6270765;55.7408687;2294;401;1893
21:00;37.6279157;55.7598754;1166;210;956
21:00;37.6290658;55.7417709;2186;517;1669
21:00;37.6317458;55.7728672;1426;439;987
21:00;37.6323159;55.7812257;1184;439;745
21:00;37.6331969;55.7797556;1414;584;830
21:00;37.633222;55.7555058;4065;711;3354
21:00;37.6361518;55.7933484;994;652;342
21:00;37.6372552;55.76613;1299;314;985
21:00;37.6374183;55.7304321;2666;857;1809
21:00;37.63768;55.7317782;2068;988;1080
21:00;37.6383529;55.8453055;580;993;-413
21:00;37.6387088;55.8086032;1801;1235;566
21:00;37.6389332;55.7659277;1528;373;1155
21:00;37.6398306;55.7668232;549;92;457
21:00;37.6411949;55.8211047;1251;1211;40
21:00;37.6484221;55.768931;1298;497;801
21:00;37.6491378;55.6549517;1115;1066;49
21:00;37.6506474;55.7416183;2021;528;1493
21:00;37.6519536;55.740344;767;306;461
21:00;37.6526488;55.7413884;2016;637;1379
21:00;37.6526672;55.8551422;823;1937;-1114
21:00;37.6545092;55.7748736;1688;1347;341
21:00;37.656231;55.7754248;1873;5572;-3699
21:00;37.6565565;55.6358179;1195;3517;-2322
21:00;37.656572;55.7571067;2194;1645;549
21:00;37.6576183;55.7073699;2219;1116;1103
21:00;37.658076;55.7581501;1916;1963;-47
21:00;37.6591277;55.7572695;1781;527;1254
21:00;37.6614511;55.8871576;971;3765;-2794
21:00;37.6638965;55.6784809;2050;3380;-1330
21:00;37.6641638;55.8697248;1100;3799;-2699
21:00;37.6661457;55.7317659;2026;1318;708
21:00;37.6667866;55.7330126;434;142;292
21:00;37.6672754;55.7803946;1259;658;601
21:00;37.6693833;55.6215598;1205;3802;-2597
21:00;37.6756382;55.718932;556;326;230
21:00;37.6801346;55.7889129;1672;1149;523
21:00;37.6801957;55.7729753;2723;1164;1559
21:00;37.6820384;55.7464709;1112;1382;-270
21:00;37.6822989;55.7457322;969;846;123
21:00;37.6850483;55.7075562;1331;728;603
21:00;37.6867847;55.7253024;931;172;759
21:00;37.6947891;55.613247;424;1712;-1288
21:00;37.7038734;55.7820537;1464;1093;371
21:00;37.7157645;55.7961475;1450;2548;-1098
21:00;37.7193262;55.6109687;2705;3840;-1135
21:00;37.7200209;55.7520069;2064;1583;481
21:00;37.7207673;55.7830875;1951;1137;814
21:00;37.7268243;55.6933636;599;1818;-1219
21:00;37.7318594;55.7087389;1661;2919;-1258
21:00;37.7344362;55.8146017;597;2008;-1411
21:00;37.7431944;55.6500225;1220;3436;-2216
21:00;37.7433398;55.6331579;192;1228;-1036
21:00;37.743772;55.621144;221;1009;-788
21:00;37.7445335;55.6137894;602;2439;-1837
21:00;37.7447684;55.8039662;409;857;-448
21:00;37.7452899;55.61193;159;631;-472
21:00;37.7498443;55.757225;735;911;-176
21:00;37.7506502;55.6596899;1460;3157;-1697
21:00;37.750729;55.788524;722;624;98
21:00;37.7532335;55.6907556;374;1195;-821
21:00;37.7619338;55.6756254;885;3359;-2474
21:00;37.7657487;55.7055754;1949;5618;-3669
21:00;37.7814948;55.787812;517;1464;-947
21:00;37.7864677;55.751266;994;3371;-2377
21:00;37.7935753;55.7170907;1160;2887;-1727
21:00;37.7985144;55.8093419;1603;5715;-4112
21:00;37.7992368;55.7947324;1010;2875;-1865
21:00;37.8166274;55.7517187;1577;7691;-6114
21:00;37.8179174;55.715631;1936;9886;-7950
22:00;37.3622257;55.8458623;453;1532;-1079
22:00;37.3824179;55.8356604;86;333;-247
22:00;37.3855554;55.825092;288;36;252
22:00;37.4031859;55.8037346;482;1090;-608
22:00;37.4082585;55.7568353;648;990;-342
22:00;37.4169177;55.7408429;843;1670;-827
22:00;37.4363874;55.860731;753;2200;-1447
22:00;37.4366398;55.8264976;744;2013;-1269
22:00;37.4397991;55.8503173;662;2513;-1851
22:00;37.4459574;55.7308185;185;287;-102
22:00;37.4460094;55.7307016;327;976;-649
22:00;37.4643097;55.8085823;1471;1343;128
22:00;37.4671944;55.7359279;66;210;-144
22:00;37.4707354;55.7296453;814;1514;-700
22:00;37.4761955;55.8548635;1127;3065;-1938
22:00;37.4832383;55.6636112;1487;3112;-1625
22:00;37.4834225;55.7394565;223;421;-198
22:00;37.4865846;55.8400444;529;1431;-902
22:00;37.4937378;55.7933364;1176;1635;-459
22:00;37.4978443;55.7436954;302;415;-113
22:00;37.4978477;55.8190209;1877;2064;-187
22:00;37.506415;55.6767308;724;1460;-736
22:00;37.5080944;55.6186964;1125;1651;-526
22:00;37.5148913;55.8049784;1055;1085;-30
22:00;37.5149237;55.7460754;747;639;108
22:00;37.5177438;55.7362565;365;316;49
22:00;37.5190729;55.6330883;462;1353;-891
22:00;37.5194078;55.7775074;1090;1400;-310
22:00;37.5262001;55.6425059;786;1674;-888
22:00;37.5324136;55.8002374;1146;1036;110
22:00;37.5337173;55.6062069;551;1844;-1293
22:00;37.5340698;55.692163;1403;1216;187
22:00;37.53429;55.7400038;147;153;-6
22:00;37.534383;55.7483228;110;36;74
22:00;37.5401361;55.6567573;1594;964;630
22:00;37.5413387;55.7500562;1027;158;869
22:00;37.5464401;55.7735045;634;852;-218
22:00;37.5483675;55.7388362;164;335;-171
22:00;37.5528619;55.6016929;46;368;-322
22:00;37.5547367;55.670291;808;1320;-512
22:00;37.5581576;55.7897125;760;846;-86
22:00;37.5591032;55.7103574;227;59;168
22:00;37.5615355;55.7645028;1453;893;560
22:00;37.5629779;55.6779484;836;1135;-299
22:00;37.5637548;55.7233832;342;359;-17
22:00;37.5660392;55.7444645;1162;999;163
22:00;37.5663098;55.7437756;2907;1000;1907
22:00;37.5736132;55.6878389;1041;1402;-361
22:00;37.5740376;55.8347143;969;2403;-1434
22:00;37.5756626;55.8182119;737;1638;-901
22:00;37.5768339;55.56931;629;2296;-1667
22:00;37.5773899;55.7605891;645;348;297
22:00;37.5794779;55.726854;1333;404;929
22:00;37.5798606;55.7609017;1151;212;939
22:00;37.5812016;55.8074277;706;797;-91
22:00;37.5822992;55.7473712;1876;309;1567
22:00;37.5826348;55.7487722;220;105;115
22:00;37.5837069;55.7766908;778;544;234
22:00;37.5840306;55.7761643;1762;810;952
22:00;37.5859796;55.7077138;1970;597;1373
22:00;37.5873192;55.8978497;758;2405;-1647
22:00;37.5876906;55.7928665;1177;926;251
22:00;37.5898414;55.8472205;391;641;-250
22:00;37.5943769;55.7355873;1028;283;745
22:00;37.5943769;55.7355873;0;0;0
22:00;37.5957904;55.7701264;1956;354;1602
22:00;37.5964216;55.582549;190;462;-272
22:00;37.5981698;55.6529571;517;1113;-596
22:00;37.598314;55.6520286;221;334;-113
22:00;37.6007529;55.7518731;246;49;197
22:00;37.6009269;55.5951773;311;1297;-986
22:00;37.6020659;55.779514;1339;364;975
22:00;37.6024384;55.8836915;431;1493;-1062
22:00;37.6029929;55.7803918;831;259;572
22:00;37.6032245;55.7450091;1100;231;869
22:00;37.6041499;55.6124609;975;1722;-747
22:00;37.6048165;55.8634536;1041;2315;-1274
22:00;37.6056238;55.7653522;3816;486;3330
22:00;37.6056692;55.6627149;410;765;-355
22:00;37.6066657;55.7508858;227;25;202
22:00;37.6067634;55.64069;685;1406;-721
22:00;37.6068123;55.7521318;1893;181;1712
22:00;37.60792;55.7194704;959;556;403
22:00;37.608832;55.7524514;636;104;532
22:00;37.6091534;55.7295817;825;247;578
22:00;37.6091666;55.622278;700;1074;-374
22:00;37.6097183;55.7649696;1281;163;1118
22:00;37.6103732;55.6722659;353;444;-91
22:00;37.6118212;55.730075;476;177;299
22:00;37.6150302;55.7813266;684;182;502
22:00;37.61611;55.7953478;1117;573;544
22:00;37.616177;55.7577183;4381;236;4145
22:00;37.6176267;55.7379525;626;146;480
22:00;37.6187593;55.6533004;1725;2243;-518
22:00;37.6188598;55.7710979;1072;199;873
22:00;37.6202837;55.7685309;512;87;425
22:00;37.621965;55.7566721;2048;146;1902
22:00;37.6220906;55.7287137;663;223;440
22:00;37.6227483;55.6830582;544;549;-5
22:00;37.6231936;55.7087682;1662;572;1090
22:00;37.6248369;55.7274387;931;235;696
22:00;37.626016;55.7607712;1173;86;1087
22:00;37.6270765;55.7408687;1282;248;1034
22:00;37.6279157;55.7598754;701;79;622
22:00;37.6290658;55.7417709;1483;274;1209
22:00;37.6317458;55.7728672;821;287;534
22:00;37.6323159;55.7812257;641;311;330
22:00;37.6331969;55.7797556;699;356;343
22:00;37.633222;55.7555058;2389;371;2018
22:00;37.6361518;55.7933484;454;420;34
22:00;37.6372552;55.76613;821;199;622
22:00;37.6374183;55.7304321;2007;569;1438
22:00;37.63768;55.7317782;1265;563;702
22:00;37.6383529;55.8453055;379;652;-273
22:00;37.6387088;55.8086032;866;827;39
22:00;37.6389332;55.7659277;945;243;702
22:00;37.6398306;55.7668232;278;69;209
22:00;37.6411949;55.8211047;732;798;-66
22:00;37.6484221;55.768931;654;325;329
22:00;37.6491378;55.6549517;544;777;-233
22:00;37.6506474;55.7416183;1663;350;1313
22:00;37.6519536;55.740344;473;197;276
22:00;37.6526488;55.7413884;1183;444;739
22:00;37.6526672;55.8551422;515;1216;-701
22:00;37.6545092;55.7748736;746;639;107
22:00;37.656231;55.7754248;1005;2985;-1980
22:00;37.6565565;55.6358179;684;2294;-1610
22:00;37.656572;55.7571067;1414;807;607
22:00;37.6576183;55.7073699;1157;709;448
22:00;37.658076;55.7581501;1377;977;400
22:00;37.6591277;55.7572695;1107;314;793
22:00;37.6614511;55.8871576;549;2508;-1959
22:00;37.6638965;55.6784809;1221;2205;-984
22:00;37.6641638;55.8697248;660;2550;-1890
22:00;37.6661457;55.7317659;1068;875;193
22:00;37.6667866;55.7330126;214;106;108
22:00;37.6672754;55.7803946;824;538;286
22:00;37.6693833;55.6215598;674;2403;-1729
22:00;37.6756382;55.718932;350;257;93
22:00;37.6801346;55.7889129;856;708;148
22:00;37.6801957;55.7729753;1592;766;826
22:00;37.6820384;55.7464709;650;695;-45
22:00;37.6822989;55.7457322;635;435;200
22:00;37.6850483;55.7075562;548;461;87
22:00;37.6867847;55.7253024;457;132;325
22:00;37.6947891;55.613247;263;1140;-877
22:00;37.7038734;55.7820537;949;740;209
22:00;37.7157645;55.7961475;803;1552;-749
22:00;37.7193262;55.6109687;1758;2553;-795
22:00;37.7200209;55.7520069;1265;998;267
22:00;37.7207673;55.7830875;983;777;206
22:00;37.7268243;55.6933636;298;1154;-856
22:00;37.7318594;55.7087389;847;2086;-1239
22:00;37.7344362;55.8146017;305;1245;-940
22:00;37.7431944;55.6500225;752;2189;-1437
22:00;37.7433398;55.6331579;134;851;-717
22:00;37.743772;55.621144;150;675;-525
22:00;37.7445335;55.6137894;343;1576;-1233
22:00;37.7447684;55.8039662;277;553;-276
22:00;37.7452899;55.61193;118;386;-268
22:00;37.7498443;55.757225;386;629;-243
22:00;37.7506502;55.6596899;1050;2033;-983
22:00;37.750729;55.788524;440;577;-137
22:00;37.7532335;55.6907556;207;798;-591
22:00;37.7619338;55.6756254;506;2143;-1637
22:00;37.7657487;55.7055754;1037;3724;-2687
22:00;37.7814948;55.787812;257;934;-677
22:00;37.7864677;55.751266;495;2301;-1806
22:00;37.7935753;55.7170907;623;1828;-1205
22:00;37.7985144;55.8093419;879;3930;-3051
22:00;37.7992368;55.7947324;484;2105;-1621
22:00;37.8166274;55.7517187;916;5053;-4137
22:00;37.8179174;55.715631;1089;6184;-5095
23:00;37.3622257;55.8458623;194;815;-621
23:00;37.3824179;55.8356604;40;140;-100
23:00;37.3855554;55.825092;43;22;21
23:00;37.4031859;55.8037346;190;510;-320
23:00;37.4082585;55.7568353;246;431;-185
23:00;37.4169177;55.7408429;287;765;-478
23:00;37.4363874;55.860731;337;1021;-684
23:00;37.4366398;55.8264976;293;798;-505
23:00;37.4397991;55.8503173;305;1198;-893
23:00;37.4459574;55.7308185;94;110;-16
23:00;37.4460094;55.7307016;180;431;-251
23:00;37.4643097;55.8085823;456;690;-234
23:00;37.4671944;55.7359279;27;87;-60
23:00;37.4707354;55.7296453;319;760;-441
23:00;37.4761955;55.8548635;495;1446;-951
23:00;37.4832383;55.6636112;549;1372;-823
23:00;37.4834225;55.7394565;81;220;-139
23:00;37.4865846;55.8400444;278;714;-436
23:00;37.4937378;55.7933364;469;726;-257
23:00;37.4978443;55.7436954;135;190;-55
23:00;37.4978477;55.8190209;1181;953;228
23:00;37.506415;55.6767308;356;676;-320
23:00;37.5080944;55.6186964;542;752;-210
23:00;37.5148913;55.8049784;456;534;-78
23:00;37.5149237;55.7460754;294;249;45
23:00;37.5177438;55.7362565;182;135;47
23:00;37.5190729;55.6330883;231;608;-377
23:00;37.5194078;55.7775074;489;623;-134
23:00;37.5262001;55.6425059;396;726;-330
23:00;37.5324136;55.8002374;417;472;-55
23:00;37.5337173;55.6062069;207;862;-655
23:00;37.5340698;55.692163;531;530;1
23:00;37.53429;55.7400038;70;72;-2
23:00;37.534383;55.7483228;52;16;36
23:00;37.5401361;55.6567573;578;481;97
23:00;37.5413387;55.7500562;227;82;145
23:00;37.5464401;55.7735045;260;271;-11
23:00;37.5483675;55.7388362;108;186;-78
23:00;37.5528619;55.6016929;26;184;-158
23:00;37.5547367;55.670291;441;575;-134
23:00;37.5581576;55.7897125;437;374;63
23:00;37.5591032;55.7103574;79;27;52
23:00;37.5615355;55.7645028;770;492;278
23:00;37.5629779;55.6779484;362;546;-184
23:00;37.5637548;55.7233832;158;156;2
23:00;37.5660392;55.7444645;494;441;53
23:00;37.5663098;55.7437756;945;451;494
23:00;37.5736132;55.6878389;428;707;-279
23:00;37.5740376;55.8347143;488;1194;-706
23:00;37.5756626;55.8182119;333;731;-398
23:00;37.5768339;55.56931;324;1033;-709
23:00;37.5773899;55.7605891;331;161;170
23:00;37.5794779;55.726854;407;182;225
23:00;37.5798606;55.7609017;555;102;453
23:00;37.5812016;55.8074277;346;334;12
23:00;37.5822992;55.7473712;741;142;599
23:00;37.5826348;55.7487722;128;37;91
23:00;37.5837069;55.7766908;383;244;139
23:00;37.5840306;55.7761643;954;382;572
23:00;37.5859796;55.7077138;483;350;133
23:00;37.5873192;55.8978497;343;1125;-782
23:00;37.5876906;55.7928665;550;439;111
23:00;37.5898414;55.8472205;186;354;-168
23:00;37.5943769;55.7355873;461;130;331
23:00;37.5943769;55.7355873;0;0;0
23:00;37.5957904;55.7701264;872;160;712
23:00;37.5964216;55.582549;105;198;-93
23:00;37.5981698;55.6529571;214;531;-317
23:00;37.598314;55.6520286;83;166;-83
23:00;37.6007529;55.7518731;99;31;68
23:00;37.6009269;55.5951773;163;618;-455
23:00;37.6020659;55.779514;582;179;403
23:00;37.6024384;55.8836915;220;717;-497
23:00;37.6029929;55.7803918;407;140;267
23:00;37.6032245;55.7450091;549;103;446
23:00;37.6041499;55.6124609;341;857;-516
23:00;37.6048165;55.8634536;459;1149;-690
23:00;37.6056238;55.7653522;1537;207;1330
23:00;37.6056692;55.6627149;171;375;-204
23:00;37.6066657;55.7508858;93;21;72
23:00;37.6067634;55.64069;373;634;-261
23:00;37.6068123;55.7521318;855;96;759
23:00;37.60792;55.7194704;432;263;169
23:00;37.608832;55.7524514;332;53;279
23:00;37.6091534;55.7295817;396;125;271
23:00;37.6091666;55.622278;352;526;-174
23:00;37.6097183;55.7649696;658;71;587
23:00;37.6103732;55.6722659;218;223;-5
23:00;37.6118212;55.730075;242;66;176
23:00;37.6150302;55.7813266;120;88;32
23:00;37.61611;55.7953478;256;212;44
23:00;37.616177;55.7577183;1647;135;1512
23:00;37.6176267;55.7379525;283;72;211
23:00;37.6187593;55.6533004;675;1028;-353
23:00;37.6188598;55.7710979;483;107;376
23:00;37.6202837;55.7685309;240;41;199
23:00;37.621965;55.7566721;655;63;592
23:00;37.6220906;55.7287137;383;85;298
23:00;37.6227483;55.6830582;279;271;8
23:00;37.6231936;55.7087682;593;306;287
23:00;37.6248369;55.7274387;273;125;148
23:00;37.626016;55.7607712;632;57;575
23:00;37.6270765;55.7408687;612;105;507
23:00;37.6279157;55.7598754;283;46;237
23:00;37.6290658;55.7417709;648;145;503
23:00;37.6317458;55.7728672;408;113;295
23:00;37.6323159;55.7812257;241;140;101
23:00;37.6331969;55.7797556;402;177;225
23:00;37.633222;55.7555058;1145;139;1006
23:00;37.6361518;55.7933484;209;199;10
23:00;37.6372552;55.76613;394;93;301
23:00;37.6374183;55.7304321;887;244;643
23:00;37.63768;55.7317782;624;267;357
23:00;37.6383529;55.8453055;157;299;-142
23:00;37.6387088;55.8086032;382;326;56
23:00;37.6389332;55.7659277;682;110;572
23:00;37.6398306;55.7668232;173;27;146
23:00;37.6411949;55.8211047;250;388;-138
23:00;37.6484221;55.768931;353;145;208
23:00;37.6491378;55.6549517;285;339;-54
23:00;37.6506474;55.7416183;545;156;389
23:00;37.6519536;55.740344;216;105;111
23:00;37.6526488;55.7413884;492;208;284
23:00;37.6526672;55.8551422;234;571;-337
23:00;37.6545092;55.7748736;410;270;140
23:00;37.656231;55.7754248;813;1140;-327
23:00;37.6565565;55.6358179;368;1068;-700
23:00;37.656572;55.7571067;837;341;496
23:00;37.6576183;55.7073699;495;428;67
23:00;37.658076;55.7581501;834;398;436
23:00;37.6591277;55.7572695;704;137;567
23:00;37.6614511;55.8871576;268;1071;-803
23:00;37.6638965;55.6784809;483;1097;-614
23:00;37.6641638;55.8697248;299;1233;-934
23:00;37.6661457;55.7317659;466;421;45
23:00;37.6667866;55.7330126;95;49;46
23:00;37.6672754;55.7803946;626;221;405
23:00;37.6693833;55.6215598;296;1151;-855
23:00;37.6756382;55.718932;165;111;54
23:00;37.6801346;55.7889129;390;354;36
23:00;37.6801957;55.7729753;769;364;405
23:00;37.6820384;55.7464709;275;289;-14
23:00;37.6822989;55.7457322;230;224;6
23:00;37.6850483;55.7075562;194;192;2
23:00;37.6867847;55.7253024;256;49;207
23:00;37.6947891;55.613247;114;526;-412
23:00;37.7038734;55.7820537;359;338;21
23:00;37.7157645;55.7961475;322;767;-445
23:00;37.7193262;55.6109687;751;1086;-335
23:00;37.7200209;55.7520069;514;458;56
23:00;37.7207673;55.7830875;398;343;55
23:00;37.7268243;55.6933636;148;568;-420
23:00;37.7318594;55.7087389;477;1002;-525
23:00;37.7344362;55.8146017;151;620;-469
23:00;37.7431944;55.6500225;416;1088;-672
23:00;37.7433398;55.6331579;87;352;-265
23:00;37.743772;55.621144;82;374;-292
23:00;37.7445335;55.6137894;147;789;-642
23:00;37.7447684;55.8039662;108;248;-140
23:00;37.7452899;55.61193;61;205;-144
23:00;37.7498443;55.757225;179;254;-75
23:00;37.7506502;55.6596899;389;1030;-641
23:00;37.750729;55.788524;180;242;-62
23:00;37.7532335;55.6907556;93;342;-249
23:00;37.7619338;55.6756254;324;994;-670
23:00;37.7657487;55.7055754;578;1746;-1168
23:00;37.7814948;55.787812;139;502;-363
23:00;37.7864677;55.751266;294;1101;-807
23:00;37.7935753;55.7170907;296;941;-645
23:00;37.7985144;55.8093419;400;1857;-1457
23:00;37.7992368;55.7947324;269;1016;-747
23:00;37.8166274;55.7517187;478;2242;-1764
23:00;37.8179174;55.715631;544;2994;-2450
23:59;37.3622257;55.8458623;73;313;-240
23:59;37.3824179;55.8356604;18;58;-40
23:59;37.3855554;55.825092;17;7;10
23:59;37.4031859;55.8037346;77;206;-129
23:59;37.4082585;55.7568353;98;137;-39
23:59;37.4169177;55.7408429;91;328;-237
23:59;37.4363874;55.860731;108;418;-310
23:59;37.4366398;55.8264976;110;341;-231
23:59;37.4397991;55.8503173;97;482;-385
23:59;37.4459574;55.7308185;35;42;-7
23:59;37.4460094;55.7307016;56;178;-122
23:59;37.4643097;55.8085823;178;268;-90
23:59;37.4671944;55.7359279;19;36;-17
23:59;37.4707354;55.7296453;109;289;-180
23:59;37.4761955;55.8548635;170;603;-433
23:59;37.4832383;55.6636112;211;564;-353
23:59;37.4834225;55.7394565;41;89;-48
23:59;37.4865846;55.8400444;106;314;-208
23:59;37.4937378;55.7933364;160;356;-196
23:59;37.4978443;55.7436954;66;74;-8
23:59;37.4978477;55.8190209;256;416;-160
23:59;37.506415;55.6767308;135;271;-136
23:59;37.5080944;55.6186964;116;269;-153
23:59;37.5148913;55.8049784;180;193;-13
23:59;37.5149237;55.7460754;73;92;-19
23:59;37.5177438;55.7362565;68;41;27
23:59;37.5190729;55.6330883;86;258;-172
23:59;37.5194078;55.7775074;161;288;-127
23:59;37.5262001;55.6425059;104;359;-255
23:59;37.5324136;55.8002374;166;211;-45
23:59;37.5337173;55.6062069;99;346;-247
23:59;37.5340698;55.692163;171;244;-73
23:59;37.53429;55.7400038;28;19;9
23:59;37.534383;55.7483228;25;4;21
23:59;37.5401361;55.6567573;161;172;-11
23:59;37.5413387;55.7500562;65;36;29
23:59;37.5464401;55.7735045;94;132;-38
23:59;37.5483675;55.7388362;28;120;-92
23:59;37.5528619;55.6016929;9;95;-86
23:59;37.5547367;55.670291;168;243;-75
23:59;37.5581576;55.7897125;138;192;-54
23:59;37.5591032;55.7103574;35;18;17
23:59;37.5615355;55.7645028;450;158;292
23:59;37.5629779;55.6779484;135;208;-73
23:59;37.5637548;55.7233832;79;75;4
23:59;37.5660392;55.7444645;253;141;112
23:59;37.5663098;55.7437756;389;148;241
23:59;37.5736132;55.6878389;170;274;-104
23:59;37.5740376;55.8347143;211;477;-266
23:59;37.5756626;55.8182119;123;292;-169
23:59;37.5768339;55.56931;125;478;-353
23:59;37.5773899;55.7605891;186;60;126
23:59;37.5794779;55.726854;157;64;93
23:59;37.5798606;55.7609017;293;41;252
23:59;37.5812016;55.8074277;130;168;-38
23:59;37.5822992;55.7473712;486;44;442
23:59;37.5826348;55.7487722;68;21;47
23:59;37.5837069;55.7766908;157;81;76
23:59;37.5840306;55.7761643;403;143;260
23:59;37.5859796;55.7077138;196;128;68
23:59;37.5873192;55.8978497;122;495;-373
23:59;37.5876906;55.7928665;199;161;38
23:59;37.5898414;55.8472205;97;148;-51
23:59;37.5943769;55.7355873;183;61;122
23:59;37.5943769;55.7355873;0;0;0
23:59;37.5957904;55.7701264;380;77;303
23:59;37.5964216;55.582549;46;101;-55
23:59;37.5981698;55.6529571;110;245;-135
23:59;37.598314;55.6520286;36;56;-20
23:59;37.6007529;55.7518731;60;14;46
23:59;37.6009269;55.5951773;75;278;-203
23:59;37.6020659;55.779514;188;85;103
23:59;37.6024384;55.8836915;107;284;-177
23:59;37.6029929;55.7803918;212;74;138
23:59;37.6032245;55.7450091;233;41;192
23:59;37.6041499;55.6124609;111;354;-243
23:59;37.6048165;55.8634536;172;490;-318
23:59;37.6056238;55.7653522;803;88;715
23:59;37.6056692;55.6627149;84;148;-64
23:59;37.6066657;55.7508858;24;6;18
23:59;37.6067634;55.64069;127;299;-172
23:59;37.6068123;55.7521318;375;31;344
23:59;37.60792;55.7194704;124;111;13
23:59;37.608832;55.7524514;95;20;75
23:59;37.6091534;55.7295817;142;37;105
23:59;37.6091666;55.622278;169;226;-57
23:59;37.6097183;55.7649696;326;24;302
23:59;37.6103732;55.6722659;77;111;-34
23:59;37.6118212;55.730075;79;25;54
23:59;37.6150302;55.7813266;50;34;16
23:59;37.61611;55.7953478;115;127;-12
23:59;37.616177;55.7577183;573;30;543
23:59;37.6176267;55.7379525;123;29;94
23:59;37.6187593;55.6533004;195;370;-175
23:59;37.6188598;55.7710979;224;45;179
23:59;37.6202837;55.7685309;103;25;78
23:59;37.621965;55.7566721;281;15;266
23:59;37.6220906;55.7287137;159;49;110
23:59;37.6227483;55.6830582;79;104;-25
23:59;37.6231936;55.7087682;252;117;135
23:59;37.6248369;55.7274387;89;55;34
23:59;37.626016;55.7607712;316;15;301
23:59;37.6270765;55.7408687;235;47;188
23:59;37.6279157;55.7598754;170;9;161
23:59;37.6290658;55.7417709;250;62;188
23:59;37.6317458;55.7728672;217;70;147
23:59;37.6323159;55.7812257;105;64;41
23:59;37.6331969;55.7797556;122;78;44
23:59;37.633222;55.7555058;518;60;458
23:59;37.6361518;55.7933484;93;85;8
23:59;37.6372552;55.76613;185;39;146
23:59;37.6374183;55.7304321;266;80;186
23:59;37.63768;55.7317782;272;100;172
23:59;37.6383529;55.8453055;53;132;-79
23:59;37.6387088;55.8086032;142;173;-31
23:59;37.6389332;55.7659277;316;41;275
23:59;37.6398306;55.7668232;87;15;72
23:59;37.6411949;55.8211047;83;151;-68
23:59;37.6484221;55.768931;184;78;106
23:59;37.6491378;55.6549517;85;149;-64
23:59;37.6506474;55.7416183;210;70;140
23:59;37.6519536;55.740344;81;30;51
23:59;37.6526488;55.7413884;204;57;147
23:59;37.6526672;55.8551422;69;273;-204
23:59;37.6545092;55.7748736;116;75;41
23:59;37.656231;55.7754248;200;312;-112
23:59;37.6565565;55.6358179;108;478;-370
23:59;37.656572;55.7571067;167;107;60
23:59;37.6576183;55.7073699;146;192;-46
23:59;37.658076;55.7581501;250;172;78
23:59;37.6591277;55.7572695;282;37;245
23:59;37.6614511;55.8871576;108;400;-292
23:59;37.6638965;55.6784809;217;488;-271
23:59;37.6641638;55.8697248;107;517;-410
23:59;37.6661457;55.7317659;182;160;22
23:59;37.6667866;55.7330126;32;26;6
23:59;37.6672754;55.7803946;90;92;-2
23:59;37.6693833;55.6215598;104;486;-382
23:59;37.6756382;55.718932;52;46;6
23:59;37.6801346;55.7889129;117;130;-13
23:59;37.6801957;55.7729753;229;143;86
23:59;37.6820384;55.7464709;70;97;-27
23:59;37.6822989;55.7457322;92;92;0
23:59;37.6850483;55.7075562;80;111;-31
23:59;37.6867847;55.7253024;76;23;53
23:59;37.6947891;55.613247;54;204;-150
23:59;37.7038734;55.7820537;172;96;76
23:59;37.7157645;55.7961475;116;309;-193
23:59;37.7193262;55.6109687;216;460;-244
23:59;37.7200209;55.7520069;170;161;9
23:59;37.7207673;55.7830875;157;146;11
23:59;37.7268243;55.6933636;78;219;-141
23:59;37.7318594;55.7087389;489;380;109
23:59;37.7344362;55.8146017;37;247;-210
23:59;37.7431944;55.6500225;128;475;-347
23:59;37.7433398;55.6331579;28;184;-156
23:59;37.743772;55.621144;40;169;-129
23:59;37.7445335;55.6137894;55;343;-288
23:59;37.7447684;55.8039662;45;104;-59
23:59;37.7452899;55.61193;26;110;-84
23:59;37.7498443;55.757225;63;135;-72
23:59;37.7506502;55.6596899;139;418;-279
23:59;37.750729;55.788524;85;120;-35
23:59;37.7532335;55.6907556;54;147;-93
23:59;37.7619338;55.6756254;117;423;-306
23:59;37.7657487;55.7055754;200;733;-533
23:59;37.7814948;55.787812;46;247;-201
23:59;37.7864677;55.751266;103;534;-431
23:59;37.7935753;55.7170907;105;427;-322
23:59;37.7985144;55.8093419;142;838;-696
23:59;37.7992368;55.7947324;101;471;-370
23:59;37.8166274;55.7517187;180;995;-815
23:59;37.8179174;55.715631;181;1088;-907